Position,RefBase,TotalReads,A,C,G,N,T,Matches,Mismatches
1,A,8000,8000,0,0,0,0,8000,0
1,T,8000,0,0,0,0,8000,8000,0
2,G,8001,0,0,8001,0,0,8001,0
2,T,8001,0,0,0,0,8001,8001,0
3,G,8002,0,0,8002,0,0,8002,0
3,T,8002,0,0,0,0,8002,8002,0
4,G,8003,1,1,8001,0,0,8001,2
4,T,8002,2,0,0,0,8000,8000,2
5,A,8003,8001,1,1,0,0,8001,2
5,T,8004,0,0,0,0,8004,8004,0
6,C,8005,0,8003,0,0,2,8003,2
6,T,8004,0,1,0,0,8000,8000,4
7,A,8006,8001,0,2,0,0,8001,5
7,T,8004,0,0,0,0,8004,8004,0
8,A,8005,8004,0,0,0,0,8004,1
8,A,8007,8007,0,0,0,0,8007,0
9,G,8008,0,0,8004,0,0,8004,4
9,T,8006,0,1,0,0,8005,8005,1
10,C,8006,1,8005,0,0,0,8005,1
10,G,8009,0,0,8009,0,0,8009,0
11,A,8010,8006,0,1,0,0,8006,4
11,T,8007,0,1,0,0,8006,8006,1
12,A,8008,8006,0,0,0,0,8006,2
12,A,8011,8010,0,0,0,1,8010,1
13,A,8009,8009,0,0,0,0,8009,0
13,G,8012,0,0,8010,0,0,8010,2
14,C,8010,0,8008,0,0,0,8008,2
14,G,8013,0,0,8012,0,1,8012,1
15,C,8014,0,8012,0,0,2,8012,2
15,T,8008,0,1,0,0,8007,8007,1
16,A,8015,8015,0,0,0,0,8015,0
16,G,8010,0,0,8010,0,0,8010,0
17,C,8012,2,8007,0,0,3,8007,5
17,C,8016,0,8015,0,0,1,8015,1
18,G,8017,0,0,7853,0,2,7853,164
18,T,8012,0,0,0,0,8012,8012,0
19,G,8013,0,0,8012,0,0,8012,1
19,G,8017,0,0,8017,0,0,8017,0
20,A,8013,8012,0,0,0,0,8012,1
20,G,8018,0,0,8018,0,0,8018,0
21,G,8019,0,0,8019,0,0,8019,0
21,T,8013,0,0,0,0,8013,8013,0
22,C,8014,0,8012,1,0,1,8012,2
22,G,8020,2,0,8018,0,0,8018,2
23,A,8020,8002,0,17,0,1,8002,18
23,G,8016,0,1,8014,0,0,8014,2
24,A,8016,8014,0,0,0,2,8014,2
24,G,8021,1,0,7963,0,0,7963,58
25,G,8018,0,0,8018,0,0,8018,0
25,G,8022,0,0,8022,0,0,8022,0
26,G,8023,0,0,8023,0,0,8023,0
26,T,8019,0,0,1,0,8018,8018,1
27,G,8020,2,0,8018,0,0,8018,2
27,G,8024,2,0,8021,0,1,8021,3
28,C,8024,0,8023,0,0,0,8023,1
28,T,8021,0,0,0,0,8021,8021,0
29,A,8022,8022,0,0,0,0,8022,0
29,A,8024,8019,0,0,0,0,8019,5
30,A,8025,8025,0,0,0,0,8025,0
30,G,8023,0,0,8023,0,0,8023,0
31,A,8026,8023,2,0,0,0,8023,3
31,C,8024,0,8023,0,0,0,8023,1
32,C,8025,0,8025,0,0,0,8025,0
32,C,8027,1,8026,0,0,0,8026,1
33,A,8026,8026,0,0,0,0,8026,0
33,A,8028,8023,0,0,0,0,8023,5
34,A,8029,8029,0,0,0,0,8029,0
34,G,8027,0,0,8027,0,0,8027,0
35,A,8028,8026,0,1,0,0,8026,2
35,C,8030,0,8028,0,0,1,8028,2
36,A,8030,8029,0,0,0,1,8029,1
36,T,8029,0,0,0,0,8029,8029,0
37,C,8030,0,8030,0,0,0,8030,0
37,G,8031,0,0,8031,0,0,8031,0
38,A,8031,8031,0,0,0,0,8031,0
38,T,8031,0,0,0,0,8031,8031,0
39,A,8031,8031,0,0,0,0,8031,0
39,T,8032,0,0,0,0,8032,8032,0
40,G,8032,2,0,8028,0,0,8028,4
40,G,8033,1,0,8031,0,0,8031,2
41,G,8034,1,0,8033,0,0,8033,1
41,T,8031,0,0,0,0,8031,8031,0
42,A,8033,8030,0,0,0,0,8030,3
42,C,8034,0,8033,0,0,1,8033,1
43,A,8034,8033,0,0,0,1,8033,1
43,T,8034,0,1,0,0,8033,8033,1
44,G,8035,0,0,8027,0,1,8027,8
44,T,8035,0,1,0,0,8034,8034,1
45,C,8036,1,8034,0,0,1,8034,2
45,G,8035,1,0,8033,0,1,8033,2
46,A,8037,8035,0,0,0,0,8035,2
46,C,8036,0,8035,0,0,0,8035,1
47,A,8037,8028,0,0,0,0,8028,9
47,A,8038,8036,0,0,0,1,8036,2
48,A,8038,8038,0,0,0,0,8038,0
48,T,8038,1,0,0,0,8031,8031,7
49,C,8039,0,8039,0,0,0,8039,0
49,T,8039,0,1,0,0,8038,8038,1
50,A,8039,8037,0,0,0,0,8037,2
50,T,8039,0,0,0,0,8039,8039,0
51,A,8040,8040,0,0,0,0,8040,0
51,C,8040,0,8038,0,0,1,8038,2
52,G,8040,0,0,8039,0,1,8039,1
52,G,8041,0,0,7995,0,0,7995,46
53,A,8041,8038,0,0,0,0,8038,3
53,G,8042,0,0,8042,0,0,8042,0
54,A,8042,8041,0,1,0,0,8041,1
54,G,8043,0,0,8042,0,1,8042,1
55,G,8043,1,0,8030,0,1,8030,13
55,G,8044,0,0,8044,0,0,8044,0
56,G,8044,3,0,8041,0,0,8041,3
56,T,8045,0,0,1,0,8044,8044,1
57,C,8045,0,8043,0,0,2,8043,2
57,C,8046,0,8046,0,0,0,8046,0
58,A,8045,8044,0,0,0,1,8044,1
58,A,8047,8044,0,1,0,0,8044,3
59,C,8046,0,8044,0,0,2,8044,2
59,T,8048,0,3,0,0,8042,8042,6
60,A,8047,8045,0,2,0,0,8045,2
60,T,8048,0,0,0,0,8048,8048,0
61,A,8049,8046,0,1,0,0,8046,3
61,G,8048,2,0,8046,0,0,8046,2
62,G,8050,0,0,8049,0,1,8049,1
62,T,8049,0,1,1,0,8047,8047,2
63,C,8049,0,8049,0,0,0,8049,0
63,T,8051,0,0,1,0,8047,8047,4
64,G,8050,1,0,8048,0,0,8048,2
64,T,8052,0,0,0,0,8052,8052,0
65,A,8050,8049,0,1,0,0,8049,1
65,C,8052,0,8052,0,0,0,8052,0
66,A,8054,8050,0,3,0,0,8050,4
66,G,8052,0,0,8044,0,1,8044,8
67,G,8053,0,0,8053,0,0,8053,0
67,T,8055,0,0,0,0,8055,8055,0
68,A,8056,8056,0,0,0,0,8056,0
68,C,8054,0,8053,0,0,1,8053,1
69,G,8057,0,0,8057,0,0,8057,0
69,T,8054,1,1,0,0,8052,8052,2
70,C,8058,0,8036,2,0,0,8036,22
70,G,8055,2,0,8053,0,0,8053,2
71,A,8056,8055,0,1,0,0,8055,1
71,C,8059,0,8059,0,0,0,8059,0
72,C,8060,0,8059,1,0,0,8059,1
72,T,8057,0,0,1,0,8056,8056,1
73,A,8061,8058,0,0,0,1,8058,3
73,C,8058,0,8058,0,0,0,8058,0
74,A,8058,8057,0,0,0,0,8057,1
74,T,8062,0,1,0,0,8060,8060,2
75,A,8063,8060,0,0,0,0,8060,3
75,G,8059,0,0,8059,0,0,8059,0
76,C,8059,0,8054,3,0,0,8054,5
76,T,8064,1,0,0,0,8063,8063,1
77,A,8065,8063,1,0,0,0,8063,2
77,G,8060,0,3,8018,0,1,8018,42
78,G,8061,1,0,8060,0,0,8060,1
78,T,8065,0,0,0,0,8063,8063,2
79,G,8062,0,0,8058,0,1,8058,4
79,G,8066,0,0,8061,0,0,8061,5
80,G,8067,0,0,8067,0,0,8067,0
80,T,8060,0,0,0,0,8024,8024,36
81,A,8067,8065,0,2,0,0,8065,2
81,T,8063,0,1,0,0,8062,8062,1
82,G,8068,0,0,8063,0,1,8063,5
82,T,8065,4,0,1,0,8058,8058,7
83,A,8064,8047,1,0,0,2,8047,17
83,T,8066,0,0,0,0,8060,8060,6
84,A,8067,8067,0,0,0,0,8067,0
84,T,8068,0,0,0,0,8067,8067,1
85,A,8067,8067,0,0,0,0,8067,0
85,C,8068,0,8059,0,0,0,8059,9
86,C,8067,1,8065,0,0,1,8065,2
86,C,8069,1,8066,0,0,1,8066,3
87,G,8068,0,1,8027,0,0,8027,41
87,G,8069,1,0,8068,0,0,8068,1
88,C,8070,0,8068,1,0,0,8068,2
88,G,8069,0,0,8069,0,0,8069,0
89,G,8070,2,0,8067,0,0,8067,3
89,G,8071,0,1,8069,0,0,8069,2
90,C,8070,0,8041,0,0,1,8041,29
90,T,8072,0,0,0,0,8070,8070,2
91,C,8072,0,8072,0,0,0,8072,0
91,T,8072,0,0,0,0,8072,8072,0
92,A,8073,8072,0,0,0,0,8072,1
92,C,8073,0,8073,0,0,0,8073,0
93,C,8073,1,8072,0,0,0,8072,1
93,T,8073,0,1,0,0,8072,8072,1
94,A,8073,8072,0,0,0,1,8072,1
94,C,8074,0,8073,0,0,0,8073,1
95,T,8074,0,0,1,0,8073,8073,1
95,T,8075,0,0,0,0,8075,8075,0
96,A,8075,8071,0,0,0,0,8071,4
96,A,8076,8076,0,0,0,0,8076,0
97,A,8076,8075,1,0,0,0,8075,1
97,G,8077,0,0,8076,0,0,8076,1
98,A,8078,8078,0,0,0,0,8078,0
98,C,8077,1,8075,0,0,0,8075,2
99,C,8079,0,8078,0,0,1,8078,1
99,T,8077,1,0,0,0,8068,8068,9
100,T,8078,0,0,0,0,8078,8078,0
100,T,8079,0,0,0,0,8078,8078,1
101,A,8079,8079,0,0,0,0,8079,0
101,C,8080,0,8080,0,0,0,8080,0
102,C,8080,0,8076,0,0,2,8076,4
102,G,8081,2,0,8078,0,0,8078,3
103,A,8082,8081,0,0,0,1,8081,1
103,G,8081,0,0,8075,0,1,8075,6
104,G,8081,0,1,8080,0,0,8080,1
104,G,8082,1,0,8080,0,0,8080,2
105,C,8081,0,8079,0,0,2,8079,2
105,T,8082,0,1,0,0,8080,8080,2
106,A,8083,8072,0,0,0,0,8072,11
106,G,8081,1,0,8075,0,0,8075,6
107,A,8083,8082,1,0,0,0,8082,1
107,G,8082,3,0,8079,0,0,8079,3
108,A,8083,8082,0,0,0,1,8082,1
108,C,8083,1,8074,1,0,0,8074,9
109,C,8084,0,8083,0,0,1,8083,1
109,T,8084,0,5,0,0,8078,8078,6
110,G,8085,2,0,8081,0,1,8081,4
110,G,8086,0,0,8079,0,0,8079,7
111,C,8086,0,8084,0,0,1,8084,2
111,G,8086,1,0,8084,0,0,8084,2
112,C,8085,0,8065,0,0,1,8065,20
112,T,8086,0,0,1,0,8074,8074,12
113,C,8086,0,8085,0,0,1,8085,1
113,T,8087,0,0,1,0,8086,8086,1
114,C,8087,0,8086,1,0,0,8086,1
114,T,8088,3,2,0,0,8082,8082,6
115,A,8088,8085,3,0,0,0,8085,3
115,G,8089,0,2,8086,0,1,8086,3
116,C,8090,0,16172,2,0,1,16172,-8082
117,C,8090,2,8087,0,0,1,8087,3
117,T,8091,1,1,0,0,8085,8085,6
118,T,8090,1,0,1,0,8087,8087,3
118,T,8092,1,0,0,0,8091,8091,1
119,G,8090,0,0,8085,0,0,8085,5
119,G,8093,2,0,8090,0,1,8090,3
120,G,8091,3,0,8087,0,1,8087,4
120,T,8093,1,2,0,0,8090,8090,3
121,A,8093,8091,0,2,0,0,8091,2
121,C,8091,0,8090,0,0,1,8090,1
122,C,8094,0,8093,0,0,1,8093,1
122,T,8091,0,0,0,0,8090,8090,1
123,A,8095,8094,1,0,0,0,8094,1
123,G,8090,2,0,8088,0,0,8088,2
124,A,8090,8088,1,1,0,0,8088,2
124,G,8096,0,0,8096,0,0,8096,0
125,C,8092,0,8086,0,0,0,8086,6
125,C,8096,0,8094,0,0,0,8094,2
126,C,8093,2,8091,0,0,0,8091,2
126,T,8097,0,2,0,0,8094,8094,3
127,C,8098,0,8095,0,0,2,8095,3
127,G,8094,3,0,8091,0,0,8091,3
128,C,8095,0,8084,1,0,0,8084,11
128,G,8099,0,0,8099,0,0,8099,0
129,C,8095,0,8095,0,0,0,8095,0
129,T,8100,0,0,0,0,8100,8100,0
130,C,8096,1,8093,0,0,2,8093,3
130,C,8100,0,8096,1,0,1,8096,4
131,A,8097,8093,0,1,0,1,8093,4
131,C,8101,1,8099,0,0,1,8099,2
132,A,8098,8096,0,1,0,0,8096,2
132,A,8102,8099,0,2,0,1,8099,3
133,C,8098,1,8097,0,0,0,8097,1
133,T,8103,0,2,0,0,8100,8100,3
134,G,8098,1,0,8094,0,1,8094,4
134,G,8104,1,0,8103,0,0,8103,1
135,A,8099,8098,0,1,0,0,8098,1
135,C,8105,0,8100,0,0,1,8100,5
136,C,8100,1,7980,0,0,0,7980,120
136,C,8106,0,8105,0,0,1,8105,1
137,C,8100,0,8100,0,0,0,8100,0
137,G,8106,0,0,8103,0,1,8103,3
138,A,8106,8106,0,0,0,0,8106,0
138,C,8102,0,8101,0,0,1,8101,1
139,C,8103,1,8101,0,0,0,8101,2
139,G,8107,1,0,8106,0,0,8106,1
140,A,8108,8108,0,0,0,0,8108,0
140,C,8103,0,8100,3,0,0,8100,3
141,G,8104,2,6,8096,0,0,8096,8
141,G,8108,0,0,8108,0,0,8108,0
142,C,8106,0,8069,4,0,1,8069,37
142,T,8109,0,0,0,0,8109,8109,0
143,C,8107,0,8107,0,0,0,8107,0
143,G,8110,0,0,8109,0,0,8109,1
144,A,8111,8111,0,0,0,0,8111,0
144,C,8108,0,8107,0,0,1,8107,1
145,A,8108,8106,0,0,0,0,8106,2
145,T,8112,1,0,0,0,8111,8111,1
146,C,8113,0,8062,0,0,0,8062,51
146,T,8109,0,0,0,0,8102,8102,7
147,C,8113,0,8113,0,0,0,8113,0
147,T,8109,1,1,1,0,8106,8106,3
148,C,8114,1,8107,1,0,1,8107,7
148,G,8110,0,0,8109,0,0,8109,1
149,A,8110,8110,0,0,0,0,8110,0
149,G,8110,1,0,8104,0,0,8104,6
150,C,8111,0,8110,0,0,1,8110,1
150,G,8114,1,0,8112,0,0,8112,2
151,C,8113,0,8110,1,0,2,8110,3
151,G,8112,1,0,8110,0,1,8110,2
152,G,8115,1,1,8105,0,0,8105,10
152,T,8112,0,1,0,0,8109,8109,3
153,C,8112,0,8112,0,0,0,8112,0
153,G,8116,0,0,8116,0,0,8116,0
154,A,8112,8103,0,0,0,0,8103,9
154,C,8117,0,8115,1,0,0,8115,2
155,A,8113,8113,0,0,0,0,8113,0
155,G,8118,1,0,8112,0,0,8112,6
156,G,8119,0,0,8119,0,0,8119,0
156,T,8114,0,0,0,0,8114,8114,0
157,A,8115,8109,0,1,0,0,8109,6
157,T,8119,0,0,0,0,8119,8119,0
158,A,8116,8115,0,1,0,0,8115,1
158,C,8120,0,8120,0,0,0,8120,0
159,A,8120,8118,0,0,0,0,8118,2
159,T,8117,0,0,0,0,8117,8117,0
160,C,8120,0,8119,0,0,1,8119,1
160,G,8118,0,0,8118,0,0,8118,0
161,A,8119,8119,0,0,0,0,8119,0
161,G,8121,0,0,8120,0,0,8120,1
162,A,8121,8112,0,0,0,0,8112,9
162,C,8120,1,8119,0,0,0,8119,1
163,A,8122,8122,0,0,0,0,8122,0
163,G,8121,2,0,8119,0,0,8119,2
164,C,8124,0,8122,0,0,1,8122,2
164,T,8122,0,0,0,0,8122,8122,0
165,A,8123,8123,0,0,0,0,8123,0
165,T,8124,0,0,0,0,8123,8123,1
166,C,8125,0,8118,0,0,0,8118,7
166,T,8124,0,1,0,0,8120,8120,4
167,C,8126,1,8125,0,0,0,8125,1
167,G,8125,0,0,8122,0,1,8122,3
168,A,8127,8127,0,0,0,0,8127,0
168,T,8126,0,0,1,0,8121,8121,5
169,G,8128,1,0,8126,0,0,8126,2
169,T,8127,0,1,0,0,8126,8126,1
170,C,8128,0,16231,0,0,2,16231,-8103
171,A,8128,8127,0,0,0,0,8127,1
171,C,8129,2,8127,0,0,0,8127,2
172,C,8130,0,8130,0,0,0,8130,0
172,G,8129,0,0,8125,0,0,8125,4
173,A,8131,8130,0,0,0,0,8130,1
173,G,8130,0,0,8130,0,0,8130,0
174,A,8131,8131,0,0,0,0,8131,0
174,T,8132,0,0,0,0,8132,8132,0
175,A,8133,8132,0,0,0,0,8132,1
175,C,8132,0,8125,0,0,0,8125,7
176,C,8133,0,8133,0,0,0,8133,0
176,G,8134,2,0,8132,0,0,8132,2
177,A,8134,8134,0,0,0,0,8134,0
177,T,8134,0,0,0,0,8134,8134,0
178,A,8135,8134,0,0,0,0,8134,1
178,T,8135,0,0,0,0,8134,8134,1
179,A,8135,8132,1,2,0,0,8132,3
179,G,8136,0,0,8135,0,1,8135,1
180,C,8136,1,8134,0,0,0,8134,2
180,T,8137,0,0,1,0,8136,8136,1
181,G,8137,1,0,8136,0,0,8136,1
181,G,8138,0,0,8138,0,0,8138,0
182,A,8139,8139,0,0,0,0,8139,0
182,C,8138,0,8125,0,0,0,8125,13
183,C,8139,1,8138,0,0,0,8138,1
183,T,8140,0,0,0,0,8140,8140,0
184,A,8140,8135,0,0,0,0,8135,5
184,C,8141,0,8139,0,0,1,8139,2
185,A,8140,8140,0,0,0,0,8140,0
185,G,8141,0,0,8141,0,0,8141,0
186,C,8142,0,8142,0,0,0,8142,0
186,T,8140,0,0,0,0,8140,8140,0
187,A,8141,8140,0,1,0,0,8140,1
187,G,8143,1,0,8142,0,0,8142,1
188,C,8144,1,8142,0,0,0,8142,2
188,G,8142,0,0,8100,0,1,8100,42
189,G,8143,0,0,8143,0,0,8143,0
189,T,8144,0,0,0,0,8142,8142,2
190,G,8144,1,0,8143,0,0,8143,1
190,T,8145,0,1,0,0,8144,8144,1
191,A,8145,8145,0,0,0,0,8145,0
191,C,8146,0,8145,0,0,1,8145,1
192,C,8146,0,8146,0,0,0,8146,0
192,T,8147,0,1,0,0,8146,8146,1
193,C,8148,0,8148,0,0,0,8148,0
193,T,8147,0,0,0,0,8137,8137,10
194,G,8149,1,0,8147,0,0,8147,2
194,T,8147,0,0,0,0,8147,8147,0
195,T,8147,0,1,0,0,8146,8146,1
195,T,8149,0,0,1,0,8143,8143,6
196,C,8148,0,8140,0,0,0,8140,8
196,T,8149,0,0,0,0,8148,8148,1
197,C,8148,0,8146,0,0,2,8146,2
197,G,8148,0,0,8117,0,0,8117,31
198,A,8149,8149,0,0,0,0,8149,0
198,G,8150,0,0,8150,0,0,8150,0
199,G,8151,0,0,8151,0,0,8151,0
199,T,8149,1,0,0,0,8142,8142,7
200,G,8153,0,0,8153,0,0,8153,0
200,T,8149,0,0,0,0,8149,8149,0
201,G,8150,0,0,8150,0,0,8150,0
201,T,8154,0,0,0,0,8154,8154,0
202,A,8151,8151,0,0,0,0,8151,0
202,C,8154,0,8152,0,0,1,8152,2
203,C,8152,0,8150,0,0,1,8150,2
203,T,8154,0,0,0,0,8146,8146,8
204,G,8153,0,0,8153,0,0,8153,0
204,T,8155,0,0,0,0,8155,8155,0
205,T,8154,0,0,0,0,8153,8153,1
205,T,8156,0,0,0,0,8156,8156,0
206,C,8154,0,8153,0,0,1,8153,1
206,G,8157,0,0,8157,0,0,8157,0
207,A,8156,8154,0,0,0,0,8154,2
207,C,8158,0,8158,0,0,0,8158,0
208,A,8157,8154,1,0,0,2,8154,3
208,T,8158,0,0,0,0,8158,8158,0
209,C,8159,0,8159,0,0,0,8159,0
209,T,8158,1,0,1,0,8153,8153,5
210,A,8159,8158,0,1,0,0,8158,1
210,G,8158,0,0,8123,0,1,8123,35
211,G,8159,0,0,8159,0,0,8159,0
211,G,8160,0,0,8159,0,1,8159,1
212,C,8161,0,8160,1,0,0,8160,1
212,G,8160,1,1,8154,0,4,8154,6
213,T,8160,1,0,2,0,8156,8156,4
213,T,8161,0,0,1,0,8156,8156,5
214,G,8161,0,0,8149,0,0,8149,12
214,T,8162,0,2,0,0,8160,8160,2
215,G,8162,1,0,8161,0,0,8161,1
215,G,8163,0,0,8158,0,0,8158,5
216,A,8163,8161,0,2,0,0,8161,2
216,G,8164,0,0,8164,0,0,8164,0
217,A,8165,8165,0,0,0,0,8165,0
217,G,8164,2,0,8161,0,1,8161,3
218,C,8166,1,8165,0,0,0,8165,1
218,T,8165,0,0,0,0,8165,8165,0
219,A,8166,8165,0,0,0,0,8165,1
219,T,8165,0,0,0,0,8165,8165,0
220,G,8163,2,0,8148,0,1,8148,15
220,T,8166,0,0,0,0,8150,8150,16
221,G,8164,0,0,8164,0,0,8164,0
221,T,8166,0,0,0,0,8166,8166,0
222,G,8165,0,0,8165,0,0,8165,0
222,T,8167,0,0,0,0,8167,8167,0
223,A,8168,8167,0,1,0,0,8167,1
223,T,8166,0,0,0,0,8166,8166,0
224,C,8169,1,8168,0,0,0,8168,1
224,G,8167,1,0,8165,0,1,8165,2
225,C,8168,0,8168,0,0,0,8168,0
225,G,8169,0,0,8167,0,0,8167,2
226,G,8170,0,0,8170,0,0,8170,0
226,T,8168,0,0,0,0,8168,8168,0
227,C,8169,0,8169,0,0,0,8169,0
227,T,8170,0,0,0,0,8170,8170,0
228,A,8170,8168,0,2,0,0,8168,2
228,A,8171,8160,0,0,0,0,8160,11
229,A,8171,8171,0,0,0,0,8171,0
229,G,8171,0,0,8167,0,0,8167,4
230,A,8172,8171,1,0,0,0,8171,1
230,G,8170,1,0,8169,0,0,8169,1
231,C,8173,0,8172,0,0,0,8172,1
231,T,8170,0,0,0,0,8170,8170,0
232,A,8171,8171,0,0,0,0,8171,0
232,T,8173,0,2,0,0,8171,8171,2
233,G,8172,0,0,8171,0,0,8171,1
233,G,8174,1,0,8173,0,0,8173,1
234,C,8175,0,8156,0,0,1,8156,19
234,T,8173,0,0,0,0,8173,8173,0
235,C,8176,0,8176,0,0,0,8176,0
235,G,8174,1,0,8171,0,0,8171,3
236,C,8177,0,8176,0,0,0,8176,1
236,G,8175,0,0,8175,0,0,8175,0
237,A,8177,8177,0,0,0,0,8177,0
237,T,8176,0,0,2,0,8166,8166,10
238,C,8178,1,8177,0,0,0,8177,1
238,T,8177,0,0,1,0,8175,8175,2
239,G,8177,1,0,8175,0,0,8175,2
239,T,8178,1,0,0,0,8171,8171,7
240,T,8179,0,1,0,0,16357,16357,-8178
241,C,8179,0,8178,0,0,0,8178,1
241,G,8180,0,0,8170,0,1,8170,10
242,G,8180,0,0,8139,0,0,8139,41
242,G,8181,0,2,8179,0,0,8179,2
243,C,8183,1,8179,0,0,3,8179,4
243,G,8181,3,1,8177,0,0,8177,4
244,A,8183,8183,0,0,0,0,8183,0
244,G,8181,0,0,8180,0,1,8180,1
245,C,8182,0,8180,0,0,0,8180,2
245,G,8184,1,0,8182,0,1,8182,2
246,A,8181,8180,0,1,0,0,8180,1
246,T,8185,0,1,0,0,8183,8183,2
247,A,8186,8184,1,0,0,1,8184,2
247,G,8182,1,0,8179,0,1,8179,3
248,C,8183,0,8182,0,0,1,8182,1
248,C,8187,0,8186,0,0,0,8186,1
249,A,8183,8183,0,0,0,0,8183,0
249,A,8187,8185,1,1,0,0,8185,2
250,G,8185,1,0,8184,0,0,8184,1
250,T,8188,0,0,0,0,8188,8188,0
251,C,8185,0,8184,0,0,0,8184,1
251,C,8189,0,8189,0,0,0,8189,0
252,A,8185,8185,0,0,0,0,8185,0
252,A,8190,8183,1,1,0,0,8183,7
253,A,8191,8190,0,1,0,0,8190,1
253,C,8186,1,8185,0,0,0,8185,1
254,G,8187,0,0,8086,0,0,8086,101
254,G,8192,1,1,8189,0,0,8189,3
255,G,8186,0,0,8186,0,0,8186,0
255,T,8193,0,0,0,0,8193,8193,0
256,G,8189,0,0,8189,0,0,8189,0
256,G,8194,2,0,8192,0,0,8192,2
257,G,8190,0,1,8188,0,1,8188,2
257,T,8194,0,0,0,0,8193,8193,1
258,A,8195,8194,0,0,0,1,8194,1
258,C,8190,0,8187,0,0,0,8187,3
259,C,8190,0,8188,0,0,2,8188,2
259,T,8196,0,0,0,0,8196,8196,0
260,C,8197,0,8195,0,0,2,8195,2
260,G,8191,0,1,8190,0,0,8190,1
261,A,8196,8192,1,1,0,1,8192,4
261,T,8192,0,0,1,0,8190,8190,2
262,C,8193,0,8191,1,0,1,8191,2
262,T,8196,1,2,0,0,8193,8193,3
263,A,8197,8196,0,0,0,1,8196,1
263,G,8194,0,0,8194,0,0,8194,0
264,C,8195,0,8189,0,0,0,8189,6
264,T,8198,0,0,0,0,8198,8198,0
265,C,8195,0,8194,0,0,1,8194,1
265,G,8198,3,0,8195,0,0,8195,3
266,C,8198,0,8192,0,0,0,8192,6
266,G,8196,0,0,8196,0,0,8196,0
267,A,8197,8194,1,0,0,0,8194,3
267,C,8199,0,8198,0,0,0,8198,1
268,A,8199,8197,0,0,0,0,8197,2
268,T,8197,0,0,0,0,8196,8196,1
269,A,8200,8198,0,2,0,0,8198,2
269,G,8198,0,0,8098,0,0,8098,100
270,G,8199,0,0,8199,0,0,8199,0
270,G,8201,1,0,8199,0,0,8199,2
271,G,8199,0,0,8199,0,0,8199,0
271,T,8201,0,0,0,0,8201,8201,0
272,A,8201,8201,0,0,0,0,8201,0
272,G,8200,0,0,8200,0,0,8200,0
273,C,8202,2,8194,0,0,3,8194,8
273,G,8201,1,0,8198,0,1,8198,3
274,G,8201,3,1,8197,0,0,8197,4
274,T,8200,0,0,1,0,8199,8199,1
275,C,8203,0,7983,3,0,3,7983,220
275,G,8202,0,0,8199,0,0,8199,3
276,C,8204,1,8203,0,0,0,8203,1
276,T,8202,0,3,0,0,8194,8194,8
277,C,8205,0,8205,0,0,0,8205,0
277,T,8203,0,0,0,0,8203,8203,0
278,C,8204,0,8202,0,0,1,8202,2
278,C,8206,0,8206,0,0,0,8206,0
279,C,8207,0,8206,0,0,1,8206,1
279,T,8205,0,0,0,0,8205,8205,0
280,G,8206,1,0,8205,0,0,8205,1
280,T,8207,0,1,0,0,8206,8206,1
281,A,8208,8208,0,0,0,0,8208,0
281,C,8208,0,8206,0,0,0,8206,2
282,T,8208,2,0,2,0,16407,16407,-8199
283,G,8210,0,1,8205,0,0,8205,5
283,T,8208,0,0,0,0,8208,8208,0
284,G,8209,1,0,8207,0,0,8207,2
284,G,8210,1,0,8207,0,1,8207,3
285,A,8209,8209,0,0,0,0,8209,0
285,T,8209,0,0,0,0,8209,8209,0
286,A,8210,8209,0,1,0,0,8209,1
286,C,8210,0,8207,1,0,2,8207,3
287,G,8211,2,0,8209,0,0,8209,2
287,G,8212,0,0,8210,0,0,8210,2
288,T,8210,0,0,0,0,8210,8210,0
288,T,8211,0,0,0,0,8211,8211,0
289,C,8211,0,8211,0,0,0,8211,0
289,G,8212,0,0,8209,0,1,8209,3
290,A,8211,8207,0,0,0,0,8207,4
290,G,8214,1,1,8212,0,0,8212,2
291,A,8212,8210,0,1,0,1,8210,2
291,T,8215,0,1,0,0,8213,8213,2
292,C,8215,0,8212,0,0,3,8212,3
292,T,8213,0,0,0,0,8213,8213,0
293,G,8214,0,0,8214,0,0,8214,0
293,G,8215,1,0,8212,0,0,8212,3
294,A,8215,8215,0,0,0,0,8215,0
294,G,8216,0,1,8215,0,0,8215,1
295,C,8216,0,16428,1,0,2,16428,-8212
296,G,8216,0,0,8213,0,0,8213,3
296,G,8217,0,1,8215,0,0,8215,2
297,A,8218,8218,0,0,0,0,8218,0
297,G,8217,0,0,8217,0,0,8217,0
298,G,8219,1,0,8218,0,0,8218,1
298,T,8218,0,0,0,0,8218,8218,0
299,A,8219,8211,0,0,0,0,8211,8
299,C,8220,0,8219,0,0,1,8219,1
300,A,8219,8218,0,1,0,0,8218,1
300,T,8220,0,2,0,0,8218,8218,2
301,A,8219,8218,0,0,0,1,8218,1
301,G,8221,2,1,8218,0,0,8218,3
302,C,8222,1,8219,0,0,2,8219,3
302,T,8219,0,0,0,0,8217,8217,2
303,A,8223,8221,0,2,0,0,8221,2
303,G,8220,2,0,8211,0,0,8211,9
304,C,8224,0,8223,0,0,1,8223,1
304,G,8221,2,0,8219,0,0,8219,2
305,C,8221,0,8202,1,0,0,8202,19
305,G,8224,1,0,8223,0,0,8223,1
306,C,8221,0,8221,0,0,0,8221,0
306,C,8225,0,8223,0,0,1,8223,2
307,C,8222,0,8222,0,0,0,8222,0
307,T,8226,0,0,0,0,8226,8226,0
308,G,8223,0,1,8221,0,1,8221,2
308,G,8226,1,0,8225,0,0,8225,1
309,C,8224,0,8214,1,0,1,8214,10
309,C,8226,0,8220,0,0,0,8220,6
310,C,8224,0,8223,0,0,1,8223,1
310,C,8226,1,8225,0,0,0,8225,1
311,G,8227,1,0,8226,0,0,8226,1
311,T,8225,0,1,0,0,8224,8224,1
312,G,8226,1,0,8217,0,2,8217,9
312,T,8228,0,0,0,0,8228,8228,0
313,C,8229,0,8220,0,0,2,8220,9
313,G,8227,1,0,8225,0,0,8225,2
314,C,8227,0,8223,0,0,3,8223,4
314,C,8230,0,8230,0,0,0,8230,0
315,A,8228,8228,0,0,0,0,8228,0
315,T,8229,1,0,0,0,8228,8228,1
316,C,8229,0,8229,0,0,0,8229,0
316,T,8228,0,0,0,0,8222,8222,6
317,G,8230,0,0,8230,0,0,8230,0
317,T,8228,0,0,0,0,8228,8228,0
318,A,8230,8230,0,0,0,0,8230,0
318,A,8231,8231,0,0,0,0,8231,0
319,T,8230,0,1,1,0,8226,8226,4
319,T,8231,0,0,0,0,8231,8231,0
320,G,8231,1,0,8228,0,1,8228,3
320,G,8232,1,0,8231,0,0,8231,1
321,C,8231,0,8217,1,0,1,8217,14
321,T,8233,0,0,0,0,8228,8228,5
322,C,8231,1,8230,0,0,0,8230,1
322,T,8233,0,1,0,0,8232,8232,1
323,C,8232,2,8229,0,0,1,8229,3
323,G,8234,0,0,8234,0,0,8234,0
324,A,8232,8230,0,2,0,0,8230,2
324,T,8235,0,0,0,0,8235,8235,0
325,G,8233,2,0,8231,0,0,8231,2
325,G,8235,1,0,8224,0,0,8224,11
326,G,8235,0,0,8234,0,1,8234,1
326,T,8234,0,0,0,0,8234,8234,0
327,A,8235,8235,0,0,0,0,8235,0
327,C,8236,2,8233,1,0,0,8233,3
328,C,8236,0,8236,0,0,0,8236,0
328,G,8237,0,1,8230,0,0,8230,7
329,A,8237,8237,0,0,0,0,8237,0
329,G,8238,1,0,8237,0,0,8237,1
330,A,8239,8237,0,1,0,0,8237,2
330,T,8237,0,1,0,0,8236,8236,1
331,G,8238,0,0,8237,0,1,8237,1
331,T,8240,0,0,0,0,8238,8238,2
332,A,8239,8237,0,1,0,0,8237,2
332,C,8239,0,8238,0,0,1,8238,1
333,C,8240,0,8240,0,0,0,8240,0
333,T,8241,2,2,0,0,8232,8232,9
334,C,8238,0,8238,0,0,0,8238,0
334,T,8241,0,0,0,0,8241,8241,0
335,G,8242,0,0,8242,0,0,8242,0
335,T,8239,1,0,0,0,8237,8237,2
336,A,8242,8240,0,0,0,0,8240,2
336,T,8240,0,1,0,0,8239,8239,1
337,A,8240,8240,0,0,0,0,8240,0
337,A,8243,8242,0,0,0,1,8242,1
338,G,8244,0,0,8244,0,0,8244,0
338,T,8240,0,0,0,0,8235,8235,5
339,G,8239,0,0,8192,0,0,8192,47
339,T,8243,0,1,0,0,8240,8240,3
340,G,8242,1,0,8241,0,0,8241,1
340,T,8243,0,0,0,0,8243,8243,0
341,C,8244,1,8243,0,0,0,8243,1
341,G,8240,0,0,8240,0,0,8240,0
342,A,8239,8239,0,0,0,0,8239,0
342,A,8245,8245,0,0,0,0,8245,0
343,C,8240,0,8239,0,0,1,8239,1
343,C,8246,0,8238,0,0,3,8238,8
344,C,8246,0,8246,0,0,0,8246,0
344,T,8241,0,0,0,0,8226,8226,15
345,T,8242,0,1,0,0,8241,8241,1
345,T,8247,1,0,1,0,8242,8242,5
346,T,8243,0,1,0,0,8241,8241,2
346,T,8247,0,0,0,0,8247,8247,0
347,C,8243,0,8234,0,0,1,8234,9
347,G,8248,1,0,8247,0,0,8247,1
348,A,8249,8248,1,0,0,0,8248,1
348,C,8245,1,8243,0,0,0,8243,2
349,T,8244,0,0,0,0,8243,8243,1
349,T,8249,0,0,0,0,8249,8249,0
350,A,8245,8245,0,0,0,0,8245,0
350,G,8250,0,0,8250,0,0,8250,0
351,C,8247,1,8246,0,0,0,8246,1
351,C,8251,0,8245,0,0,0,8245,6
352,C,8251,1,8249,0,0,1,8249,2
352,T,8246,0,1,0,0,8243,8243,3
353,G,8252,1,0,8250,0,1,8250,2
353,T,8247,0,0,0,0,8247,8247,0
354,G,8248,0,0,8241,0,0,8241,7
354,T,8253,0,0,1,0,8246,8246,7
355,G,8249,0,0,8249,0,0,8249,0
355,T,8254,0,1,0,0,8253,8253,1
356,C,8250,0,8250,0,0,0,8250,0
356,C,8254,0,8253,0,0,0,8253,1
357,A,8251,8250,0,1,0,0,8250,1
357,T,8255,0,1,0,0,8248,8248,7
358,G,8252,1,0,8251,0,0,8251,1
358,T,8256,0,0,0,0,8256,8256,0
359,C,8257,0,8255,0,0,1,8255,2
359,T,8253,0,0,0,0,8253,8253,0
360,A,8254,8254,0,0,0,0,8254,0
360,T,8257,0,0,0,0,8257,8257,0
361,C,8255,1,8253,0,0,1,8253,2
361,G,8258,0,0,8258,0,0,8258,0
362,A,8255,8255,0,0,0,0,8255,0
362,C,8259,0,8259,0,0,0,8259,0
363,T,8256,0,0,0,0,8254,8254,2
363,T,8258,0,1,0,0,8253,8253,5
364,C,8256,0,8256,0,0,0,8256,0
364,T,8259,0,0,1,0,8258,8258,1
365,G,8260,0,0,8260,0,0,8260,0
365,T,8258,0,0,0,0,8258,8258,0
366,A,8259,8258,0,1,0,0,8258,1
366,T,8260,0,1,0,0,8259,8259,1
367,C,8260,0,8258,1,0,0,8258,2
367,C,8261,0,8258,0,0,2,8258,3
368,G,8261,0,0,16517,0,0,16517,-8256
369,G,8262,1,0,8259,0,2,8259,3
369,T,8262,0,0,0,0,8262,8262,0
370,A,8262,8261,0,1,0,0,8261,1
370,C,8263,0,8261,0,0,0,8261,2
371,C,8264,1,8263,0,0,0,8263,1
371,T,8263,0,0,1,0,8262,8262,1
372,A,8265,8263,1,1,0,0,8263,2
372,T,8263,1,1,1,0,8260,8260,3
373,A,8264,8263,1,0,0,0,8263,1
373,T,8266,0,0,0,0,8266,8266,0
374,G,8265,0,0,8265,0,0,8265,0
374,G,8267,0,0,8267,0,0,8267,0
375,A,8268,8264,0,0,0,1,8264,4
375,T,8263,0,0,0,0,8263,8263,0
376,C,8264,0,8264,0,0,0,8264,0
376,T,8269,0,1,0,0,8267,8267,2
377,A,8263,8263,0,0,0,0,8263,0
377,A,8269,8269,0,0,0,0,8269,0
378,T,8264,0,0,0,0,8264,8264,0
378,T,8270,0,0,0,0,8270,8270,0
379,A,8269,8267,0,0,0,0,8267,2
379,C,8265,0,8263,0,0,1,8263,2
380,G,8266,0,0,8265,0,0,8265,1
380,G,8270,0,0,8269,0,0,8269,1
381,A,8271,8271,0,0,0,0,8271,0
381,C,8266,0,8266,0,0,0,8266,0
382,C,8272,1,8271,0,0,0,8271,1
382,T,8265,0,0,0,0,8263,8263,2
383,A,8267,8267,0,0,0,0,8267,0
383,G,8269,2,0,8267,0,0,8267,2
384,T,8268,0,0,1,0,8263,8263,5
384,T,8269,0,1,1,0,8259,8259,10
385,T,8269,0,0,0,0,8269,8269,0
385,T,8270,0,1,0,0,8268,8268,2
386,A,8270,8269,1,0,0,0,8269,1
386,G,8270,0,0,8270,0,0,8270,0
387,C,8271,1,8267,0,0,0,8267,4
387,T,8271,0,0,0,0,8271,8271,0
388,C,8269,1,8268,0,0,0,8268,1
388,G,8272,0,0,8267,0,0,8267,5
389,A,8270,8268,1,0,0,0,8268,2
389,G,8273,0,0,8273,0,0,8273,0
390,C,8273,0,8270,0,0,1,8270,3
390,T,8269,0,0,0,0,8269,8269,0
391,G,8270,0,0,8269,0,0,8269,1
391,T,8274,0,0,0,0,8272,8272,2
392,C,8271,1,8267,2,0,1,8267,4
392,G,8274,1,0,8273,0,0,8273,1
393,T,8272,1,0,0,0,8271,8271,1
393,T,8275,0,2,1,0,8268,8268,7
394,G,8273,1,0,8272,0,0,8272,1
394,T,8276,1,1,0,0,8274,8274,2
395,A,8273,8273,0,0,0,0,8273,0
395,G,8277,1,0,8276,0,0,8276,1
396,T,8273,0,0,0,0,8271,8271,2
396,T,8279,0,1,0,0,8277,8277,2
397,A,8278,8276,0,1,0,1,8276,2
397,G,8274,0,0,8274,0,0,8274,0
398,C,8275,0,8275,0,0,0,8275,0
398,G,8280,0,0,8280,0,0,8280,0
399,G,8276,1,1,8266,0,1,8266,10
399,T,8279,0,1,0,0,8277,8277,2
400,G,8277,0,0,8277,0,0,8277,0
400,T,8280,0,1,0,0,8278,8278,2
401,G,8278,0,0,8278,0,0,8278,0
401,T,8277,0,0,0,0,8240,8240,37
402,T,8276,0,0,0,0,8276,8276,0
402,T,8278,0,1,0,0,8277,8277,1
403,A,8277,8275,1,0,0,1,8275,2
403,T,8278,0,0,0,0,8278,8278,0
404,C,8278,1,8277,0,0,0,8277,1
404,T,8279,0,0,2,0,8276,8276,3
405,G,8278,0,0,8261,0,2,8261,17
405,T,8279,0,1,0,0,8275,8275,4
406,C,8280,0,8274,0,0,0,8274,6
406,G,8280,0,0,8279,0,1,8279,1
407,C,8278,0,8278,0,0,0,8278,0
407,C,8281,0,8278,0,0,2,8278,3
408,A,8279,8278,0,0,0,0,8278,1
408,A,8281,8278,1,0,0,1,8278,3
409,G,8279,1,0,8278,0,0,8278,1
409,G,8282,0,0,8281,0,1,8281,1
410,C,8279,0,8279,0,0,0,8279,0
410,T,8283,0,1,0,0,8281,8281,2
411,A,8284,8284,0,0,0,0,8284,0
411,T,8279,1,0,0,0,8275,8275,4
412,C,8285,0,8285,0,0,0,8285,0
412,T,8279,0,0,0,0,8278,8278,1
413,A,8286,8282,3,0,0,0,8282,4
413,G,8279,0,0,8278,0,0,8278,1
414,T,8280,0,1,0,0,8279,8279,1
414,T,8287,1,3,0,0,8283,8283,4
415,C,8288,0,8288,0,0,0,8288,0
415,G,8281,1,0,8280,0,0,8280,1
416,A,8288,8282,0,0,0,0,8282,6
416,C,8282,0,8244,0,0,2,8244,38
417,A,8288,8287,0,0,0,1,8287,1
417,C,8283,0,8282,0,0,1,8282,1
418,C,8283,1,8282,0,0,0,8282,1
418,T,8288,0,0,0,0,8288,8288,0
419,C,8284,0,8283,0,0,1,8283,1
419,G,8289,0,0,8245,0,0,8245,44
420,A,8285,8285,0,0,0,0,8285,0
420,G,8287,0,0,8286,0,1,8286,1
421,G,8286,0,0,8282,0,0,8282,4
421,G,8287,0,0,8287,0,0,8287,0
422,C,8287,0,8285,0,0,1,8285,2
422,G,8285,1,0,8283,0,1,8283,2
423,A,8287,8286,1,0,0,0,8286,1
423,G,8288,2,0,8284,0,0,8284,4
424,T,8288,0,2,0,0,16572,16572,-8284
425,G,8287,1,0,8286,0,0,8286,1
425,G,8289,0,0,8280,0,0,8280,9
426,G,8290,0,0,8289,0,1,8289,1
426,T,8289,0,1,0,0,8284,8284,5
427,A,8291,8289,0,0,0,0,8289,2
427,T,8289,0,0,0,0,8289,8289,0
428,G,8290,3,0,8287,0,0,8287,3
428,T,8291,0,0,0,0,8291,8291,0
429,A,8291,8290,0,1,0,0,8290,1
429,C,8291,0,8288,0,0,3,8288,3
430,C,8289,0,8288,1,0,0,8288,1
430,G,8292,0,0,8292,0,0,8292,0
431,C,8293,2,8290,1,0,0,8290,3
431,G,8290,0,0,8290,0,0,8290,0
432,G,8294,1,1,8279,0,1,8279,15
432,T,8290,0,1,0,0,8289,8289,1
433,C,8291,0,8284,0,0,1,8284,7
433,G,8295,0,0,8291,0,1,8291,4
434,C,8292,0,8291,0,0,0,8291,1
434,T,8293,0,1,0,0,8273,8273,20
435,T,8292,0,0,0,0,8291,8291,1
435,T,8296,0,2,0,0,8294,8294,2
436,C,8294,1,8290,0,0,0,8290,4
436,T,8296,0,1,0,0,8295,8295,1
437,C,8294,1,8293,0,0,0,8293,1
437,G,8297,0,0,8297,0,0,8297,0
438,A,8298,8297,0,1,0,0,8297,1
438,T,8295,0,1,0,0,8286,8286,9
439,C,8299,0,8298,0,0,0,8298,1
439,T,8295,0,1,0,0,8294,8294,1
440,G,8296,1,0,8294,0,1,8294,2
440,T,8299,1,0,0,0,8298,8298,1
441,A,8297,8296,0,1,0,0,8296,1
441,C,8299,0,8299,0,0,0,8299,0
442,A,8298,16596,0,0,0,0,16596,-8298
443,C,8299,0,8298,0,0,1,8298,1
443,G,8299,0,0,8299,0,0,8299,0
444,G,8299,2,0,8210,0,2,8210,89
444,T,8299,0,0,1,0,8298,8298,1
445,C,8298,0,8297,0,0,0,8297,1
445,G,8299,1,0,8296,0,2,8296,3
446,G,8298,0,0,8297,0,1,8297,1
446,G,8301,0,0,8301,0,0,8301,0
447,A,8299,8298,0,0,0,1,8298,1
447,G,8302,3,0,8299,0,0,8299,3
448,A,8303,8296,0,6,0,1,8296,7
448,T,8299,0,1,0,0,8298,8298,1
449,G,8300,1,0,8299,0,0,8299,1
449,T,8304,2,0,0,0,8287,8287,17
450,C,8301,0,8287,0,0,1,8287,14
450,T,8305,0,0,0,0,8305,8305,0
451,C,8302,1,8301,0,0,0,8301,1
451,T,8306,0,1,0,0,8305,8305,1
452,C,8303,2,8301,0,0,0,8301,2
452,C,8307,0,8294,0,0,0,8294,13
453,C,8307,0,8307,0,0,0,8307,0
453,T,8303,0,0,0,0,8296,8296,7
454,A,8306,8299,0,4,0,1,8299,7
454,T,8303,0,0,0,0,8303,8303,0
455,A,8306,8306,0,0,0,0,8306,0
455,C,8303,1,8302,0,0,0,8302,1
456,A,8302,8301,0,1,0,0,8301,1
456,G,8307,0,0,8307,0,0,8307,0
457,G,8303,0,0,8303,0,0,8303,0
457,T,8308,0,0,0,0,8308,8308,0
458,C,8304,0,8304,0,0,0,8304,0
458,C,8308,0,8307,1,0,0,8307,1
459,T,8305,1,1,0,0,16607,16607,-8302
460,C,8306,0,16606,1,0,1,16606,-8300
461,C,8306,0,8306,0,0,0,8306,0
461,G,8306,0,0,8306,0,0,8306,0
462,A,8307,16613,1,0,0,0,16613,-8306
463,C,8308,0,8259,0,0,1,8259,49
463,T,8307,0,1,0,0,8306,8306,1
464,C,8308,0,8308,0,0,0,8308,0
464,G,8308,1,0,8307,0,0,8307,1
465,C,8308,1,8307,0,0,0,8307,1
465,C,8309,0,8309,0,0,0,8309,0
466,C,8309,0,8309,0,0,0,8309,0
466,G,8308,0,0,8301,0,4,8301,7
467,A,8310,8310,0,0,0,0,8310,0
467,G,8309,0,0,8309,0,0,8309,0
468,T,8310,1,1,0,0,16605,16605,-8295
469,T,8310,0,1,0,0,8309,8309,1
469,T,8311,1,1,0,0,8309,8309,2
470,C,8312,0,8312,0,0,0,8312,0
470,G,8311,1,0,8310,0,0,8310,1
471,A,8312,16621,1,1,0,0,16621,-8309
472,C,8313,2,16621,0,0,2,16621,-8308
473,C,8313,1,8312,0,0,0,8312,1
473,G,8314,2,0,8311,0,1,8311,3
474,A,8313,8310,1,2,0,0,8310,3
474,T,8313,0,0,1,0,8312,8312,1
475,C,8314,1,8313,0,0,0,8313,1
475,G,8314,0,0,8294,0,0,8294,20
476,A,8314,8306,1,1,0,0,8306,8
476,G,8314,0,0,8314,0,0,8314,0
477,A,8315,8314,1,0,0,0,8314,1
477,G,8315,1,0,8313,0,1,8313,2
478,T,8311,0,0,0,0,8309,8309,2
478,T,8315,0,1,0,0,8313,8313,2
479,G,8311,2,0,8308,0,1,8308,3
479,G,8316,0,0,8279,0,1,8279,37
480,G,8317,0,0,8317,0,0,8317,0
480,T,8311,0,1,0,0,8309,8309,2
481,C,8310,0,8308,0,0,2,8308,2
481,G,8318,1,0,8317,0,0,8317,1
482,A,8316,8316,0,0,0,0,8316,0
482,G,8310,2,0,8307,0,0,8307,3
483,C,8310,0,8297,0,0,1,8297,13
483,G,8317,1,0,8315,0,0,8315,2
484,C,8311,0,8311,0,0,0,8311,0
484,T,8317,0,2,0,0,8301,8301,16
485,C,8311,1,8310,0,0,0,8310,1
485,T,8316,0,2,0,0,8314,8314,2
486,T,8311,0,0,0,0,8310,8310,1
486,T,8317,0,2,1,0,8314,8314,3
487,C,8313,0,8311,0,0,2,8311,2
487,G,8318,0,0,8318,0,0,8318,0
488,G,8314,1,0,8312,0,0,8312,2
488,T,8318,1,0,0,0,8275,8275,43
489,A,8315,8311,0,0,0,0,8311,4
489,T,8318,1,0,0,0,8317,8317,1
490,A,8315,8315,0,0,0,0,8315,0
490,T,8317,0,0,0,0,8317,8317,0
491,C,8316,0,8314,0,0,2,8314,2
491,T,8316,0,0,0,0,8316,8316,0
492,G,8316,0,0,8309,0,1,8309,7
492,T,8314,2,0,0,0,8309,8309,5
493,G,8317,2,0,8315,0,0,8315,2
493,T,8315,0,3,0,0,8312,8312,3
494,C,8315,0,8315,0,0,0,8315,0
494,C,8317,0,8317,0,0,0,8317,0
495,A,8316,8316,0,0,0,0,8316,0
495,A,8318,8317,0,1,0,0,8317,1
496,C,8317,1,8311,0,0,2,8311,6
496,C,8319,1,8307,0,0,0,8307,12
497,C,8317,0,8317,0,0,0,8317,0
497,C,8319,0,8317,0,0,0,8317,2
498,A,8318,8267,0,0,0,1,8267,51
498,T,8316,0,2,0,0,8314,8314,2
499,A,8321,8321,0,0,0,0,8321,0
499,C,8317,1,8316,0,0,0,8316,1
500,A,8322,8322,0,0,0,0,8322,0
500,G,8318,1,0,8307,0,0,8307,11
501,A,8323,8323,0,0,0,0,8323,0
501,G,8319,2,0,8312,0,0,8312,7
502,C,8314,0,8313,0,0,0,8313,1
502,T,8323,0,0,0,0,8323,8323,0
503,C,8322,0,8322,0,0,0,8322,0
503,G,8319,1,0,8317,0,0,8317,2
504,A,8322,8312,0,1,0,0,8312,10
504,C,8320,0,8318,0,0,1,8318,2
505,A,8322,8321,1,0,0,0,8321,1
505,G,8319,1,0,8291,0,0,8291,28
506,C,8323,0,8322,1,0,0,8322,1
506,G,8320,0,0,8320,0,0,8320,0
507,G,8321,0,0,8321,0,0,8321,0
507,G,8323,0,0,8268,0,0,8268,55
508,G,8323,1,0,8322,0,0,8322,1
508,T,8322,0,0,0,0,8322,8322,0
509,C,8322,0,8322,0,0,0,8322,0
509,G,8325,0,0,8325,0,0,8325,0
510,A,8326,8324,0,1,0,1,8324,2
510,T,8323,0,0,0,0,8316,8316,7
511,C,8327,0,8327,0,0,0,8327,0
511,T,8324,0,2,0,0,8322,8322,2
512,G,8325,0,0,8325,0,0,8325,0
512,T,8327,1,0,0,0,8306,8306,21
513,T,8326,0,0,0,0,8326,8326,0
513,T,8328,0,0,0,0,8328,8328,0
514,A,8326,8323,0,2,0,0,8323,3
514,T,8329,1,2,1,0,8325,8325,4
515,C,8330,1,8314,0,0,0,8314,16
515,G,8327,0,0,8327,0,0,8327,0
516,C,8331,1,8328,0,0,1,8328,3
516,T,8320,0,0,0,0,8318,8318,2
517,A,8330,8277,1,0,0,0,8277,53
517,T,8320,0,0,0,0,8320,8320,0
518,A,8331,8331,0,0,0,0,8331,0
518,G,8321,2,0,8319,0,0,8319,2
519,A,8331,8331,0,0,0,0,8331,0
519,C,8322,0,8317,0,0,1,8317,5
520,A,8332,8330,1,0,0,1,8330,2
520,C,8322,1,8320,0,0,1,8320,2
521,G,8323,1,0,8322,0,0,8322,1
521,T,8333,1,1,0,0,8331,8331,2
522,G,8333,2,0,8330,0,0,8330,3
522,T,8324,0,1,0,0,8322,8322,2
523,C,8324,0,8322,0,0,0,8322,2
523,T,8332,0,0,0,0,8332,8332,0
524,C,8333,1,8330,0,0,2,8330,3
524,G,8326,1,0,8323,0,1,8323,3
525,G,8335,2,0,8333,0,0,8333,2
525,T,8327,0,0,0,0,8326,8326,1
526,C,8328,0,8319,0,0,0,8319,9
526,T,8336,0,1,0,0,8335,8335,1
527,A,8336,8333,0,0,0,0,8333,3
527,C,8329,0,8328,0,0,1,8328,1
528,A,8335,8335,0,0,0,0,8335,0
528,T,8330,0,0,0,0,8327,8327,3
529,C,8336,1,8333,0,0,1,8333,3
529,T,8330,0,2,0,0,8328,8328,2
530,A,8335,8330,1,0,0,0,8330,5
530,G,8330,0,0,8330,0,0,8330,0
531,A,8331,8326,0,0,0,0,8326,5
531,A,8334,8334,0,0,0,0,8334,0
532,A,8331,8331,0,0,0,0,8331,0
532,C,8335,0,8335,0,0,0,8335,0
533,G,8333,1,0,8332,0,0,8332,1
533,T,8335,1,1,0,0,8333,8333,2
534,A,8334,8326,0,0,0,0,8326,8
534,C,8336,0,8325,0,0,1,8325,11
535,A,8335,8333,0,0,0,2,8333,2
535,C,8335,0,8334,0,0,1,8334,1
536,G,8336,0,0,16667,0,1,16667,-8331
537,A,8337,8337,0,0,0,0,8337,0
537,C,8337,0,8267,0,0,2,8267,70
538,C,8336,1,8335,0,0,0,8335,1
538,T,8338,0,0,0,0,8335,8335,3
539,C,8338,0,8338,0,0,0,8338,0
539,G,8336,0,0,8333,0,0,8333,3
540,C,8338,0,8338,0,0,0,8338,0
540,G,8337,1,0,8336,0,0,8336,1
541,A,8339,8336,0,2,0,0,8336,3
541,T,8337,0,0,1,0,8335,8335,2
542,G,8338,1,0,8337,0,0,8337,1
542,T,8339,1,0,0,0,8333,8333,6
543,C,8338,0,8335,0,0,2,8335,3
543,T,8339,1,2,0,0,8336,8336,3
544,G,8339,2,0,8334,0,1,8334,5
544,G,8340,2,0,8338,0,0,8338,2
545,A,8341,8340,0,0,0,0,8340,1
545,C,8339,0,8338,0,0,1,8338,1
546,C,8342,0,8342,0,0,0,8342,0
546,T,8338,0,2,0,0,8336,8336,2
547,C,8340,0,8331,0,0,2,8331,9
547,G,8342,0,1,8340,0,0,8340,2
548,C,8339,0,8339,0,0,0,8339,0
548,C,8341,0,8341,0,0,0,8341,0
549,A,8340,8328,0,0,0,1,8328,12
549,T,8338,0,0,1,0,8337,8337,1
550,A,8340,8338,0,2,0,0,8338,2
550,G,8339,0,0,8331,0,1,8331,8
551,A,8340,8340,0,0,0,0,8340,0
551,G,8340,1,0,8339,0,0,8339,1
552,A,8341,8337,1,2,0,1,8337,4
552,T,8340,1,0,0,0,8338,8338,2
553,C,8341,0,8338,1,0,1,8338,3
553,G,8341,0,0,8319,0,2,8319,22
554,G,8326,4,1,8319,0,0,8319,7
554,G,8342,0,0,8340,0,2,8340,2
555,G,8343,0,0,8343,0,0,8343,0
555,T,8326,0,0,0,0,8326,8326,0
556,A,8324,8322,1,0,0,1,8322,2
556,C,8344,0,8343,0,0,1,8343,1
557,G,8325,1,0,8323,0,0,8323,2
557,G,8344,1,0,8335,0,1,8335,9
558,C,8327,0,8325,0,0,1,8325,2
558,G,8345,2,0,8343,0,0,8343,2
559,C,8326,1,8325,0,0,0,8325,1
559,T,8344,0,1,0,0,8343,8343,1
560,A,8345,8343,0,0,0,1,8343,2
560,T,8323,0,1,0,0,8317,8317,6
561,G,8345,0,0,8338,0,0,8338,7
561,T,8323,0,1,0,0,8322,8322,1
562,C,8323,0,8318,0,0,5,8318,5
562,G,8346,0,0,8346,0,0,8346,0
563,C,8347,1,8344,0,0,2,8344,3
563,G,8324,0,0,8308,0,0,8308,16
564,G,8325,1,0,8324,0,0,8324,1
564,G,8348,2,0,8343,0,0,8343,5
565,G,8325,0,0,8325,0,0,8325,0
565,T,8348,0,0,0,0,8348,8348,0
566,C,8323,0,8321,0,0,2,8321,2
566,G,8349,1,0,8347,0,0,8347,2
567,A,8322,8322,0,0,0,0,8322,0
567,T,8350,0,1,1,0,8348,8348,2
568,A,8351,8350,0,0,0,0,8350,1
568,T,8322,0,2,0,0,8320,8320,2
569,C,8351,0,8350,0,0,1,8350,1
569,G,8323,0,0,8315,0,0,8315,8
570,G,8324,0,0,8324,0,0,8324,0
570,G,8350,0,0,8340,0,0,8340,10
571,C,8324,1,8320,0,0,3,8320,4
571,G,8350,0,0,8348,0,1,8348,2
572,G,8325,0,0,8317,0,0,8317,8
572,T,8348,0,0,1,0,8347,8347,1
573,G,8326,0,0,8326,0,0,8326,0
573,G,8348,1,0,8327,0,1,8327,21
574,A,8327,8327,0,0,0,0,8327,0
574,G,8347,0,0,8347,0,0,8347,0
575,C,8328,0,8328,0,0,0,8328,0
575,G,8349,0,0,8348,0,0,8348,1
576,A,8348,8346,0,1,0,0,8346,2
576,T,8328,0,2,0,0,8323,8323,5
577,G,8350,0,0,8343,0,0,8343,7
577,T,8329,0,1,0,0,8328,8328,1
578,G,8330,0,0,8329,0,0,8329,1
578,G,8350,0,0,8350,0,0,8350,0
579,A,8330,8323,0,3,0,0,8323,7
579,T,8351,0,0,1,0,8350,8350,1
580,A,8330,8329,0,0,0,1,8329,1
580,C,8352,0,8350,0,0,1,8350,2
581,G,8331,1,0,8330,0,0,8330,1
581,T,8352,1,1,0,0,8348,8348,4
582,A,8332,8332,0,0,0,0,8332,0
582,A,8353,8350,0,1,0,0,8350,3
583,A,8333,8332,0,1,0,0,8332,1
583,T,8354,1,0,0,0,8353,8353,1
584,A,8355,8355,0,0,0,0,8355,0
584,G,8334,0,0,8334,0,0,8334,0
585,T,8334,0,0,0,0,8334,8334,0
585,T,8355,0,0,1,0,8353,8353,2
586,A,8350,8344,0,0,0,1,8344,6
586,C,8333,0,8329,0,0,4,8329,4
587,A,8345,8342,0,1,0,2,8342,3
587,G,8334,0,0,8332,0,1,8332,2
588,G,8346,0,0,8345,0,1,8345,1
588,T,8334,0,1,0,0,8333,8333,1
589,C,8344,0,8343,0,0,0,8343,1
589,G,8334,2,0,8332,0,0,8332,2
590,A,8332,8332,0,0,0,0,8332,0
590,C,8334,0,8332,0,0,0,8332,2
591,G,8330,0,0,8330,0,0,8330,0
591,T,8335,0,2,1,0,8332,8332,3
592,A,8329,8328,0,0,0,0,8328,1
592,G,8336,0,0,8336,0,0,8336,0
593,C,8335,0,8335,0,0,0,8335,0
593,G,8330,0,0,8330,0,0,8330,0
594,C,8331,1,8330,0,0,0,8330,1
594,T,8336,0,0,0,0,8335,8335,1
595,T,8329,0,1,0,0,8328,8328,1
595,T,8337,0,0,0,0,8337,8337,0
596,C,8336,0,8336,0,0,0,8336,0
596,G,8330,0,0,8310,0,0,8310,20
597,A,8337,8335,0,1,0,0,8335,2
597,G,8331,1,0,8329,0,1,8329,2
598,T,8331,1,1,0,0,8310,8310,21
598,T,8337,0,3,0,0,8332,8332,5
599,G,8337,0,0,8335,0,0,8335,2
599,T,8332,1,0,0,0,8331,8331,1
600,T,8331,0,0,0,0,8331,8331,0
600,T,8337,0,0,0,0,8337,8337,0
601,A,8332,8329,0,3,0,0,8329,3
601,G,8327,1,0,8316,0,1,8316,11
602,G,8329,0,0,8329,0,0,8329,0
602,G,8333,0,0,8333,0,0,8333,0
603,T,8330,0,0,0,0,8328,8328,2
603,T,8332,1,1,0,0,8329,8329,3
604,C,8330,0,8327,1,0,1,8327,3
604,G,8332,2,0,8330,0,0,8330,2
605,A,8330,8327,0,2,0,0,8327,3
605,G,8331,1,1,8265,0,0,8265,66
606,A,8329,8328,0,1,0,0,8328,1
606,G,8329,0,0,8329,0,0,8329,0
607,C,8330,0,8318,0,0,0,8318,12
607,G,8331,0,0,8331,0,0,8331,0
608,C,8330,0,8329,1,0,0,8329,1
608,G,8332,1,0,8331,0,0,8331,1
609,G,8331,2,1,8328,0,0,8328,3
609,T,8332,0,0,0,0,8330,8330,2
610,A,8329,8326,0,0,0,0,8326,3
610,T,8331,1,0,0,0,8330,8330,1
611,C,8331,0,8331,0,0,0,8331,0
611,G,8329,0,0,8327,0,1,8327,2
612,A,8331,8328,0,2,0,1,8328,3
612,C,8330,0,8329,1,0,0,8329,1
613,G,8331,0,0,8322,0,0,8322,9
613,G,8332,0,0,8331,0,0,8331,1
614,A,8333,8332,1,0,0,0,8332,1
614,G,8332,0,0,8332,0,0,8332,0
615,C,8328,0,8324,1,0,3,8324,4
615,T,8332,0,0,0,0,8332,8332,0
616,C,8331,0,8330,0,0,1,8330,1
616,T,8329,0,1,0,0,8328,8328,1
617,A,8330,8328,0,2,0,0,8328,2
617,G,8330,0,0,8330,0,0,8330,0
618,A,8331,8329,0,0,0,1,8329,2
618,G,8331,0,0,8329,0,0,8329,2
619,A,8331,16660,1,1,0,0,16660,-8329
620,G,8332,1,0,8331,0,0,8331,1
620,T,8332,0,0,0,0,8332,8332,0
621,C,8332,0,8332,0,0,0,8332,0
621,C,8333,0,8332,0,0,1,8332,1
622,A,8332,8332,0,0,0,0,8332,0
622,T,8330,0,1,0,0,8323,8323,7
623,C,8333,0,8332,0,0,0,8332,1
623,T,8331,0,2,0,0,8329,8329,2
624,T,8331,0,0,1,0,16661,16661,-8330
625,G,8332,5,0,16658,0,0,16658,-8326
626,C,8331,0,8330,0,0,1,8330,1
626,T,8332,0,0,0,0,8331,8331,1
627,A,8329,8329,0,0,0,0,8329,0
627,C,8331,0,8331,0,0,0,8331,0
628,C,8330,0,8327,0,0,2,8327,3
628,G,8332,0,0,8332,0,0,8332,0
629,A,8332,8330,0,0,0,0,8330,2
629,G,8330,0,0,8328,0,1,8328,2
630,C,8331,0,8326,0,0,1,8326,5
630,T,8333,1,0,0,0,8332,8332,1
631,C,8330,0,8330,0,0,0,8330,0
631,C,8334,1,8328,0,0,1,8328,6
632,C,8333,2,8331,0,0,0,8331,2
632,G,8327,0,0,8327,0,0,8327,0
633,T,8327,0,0,0,0,8327,8327,0
633,T,8333,0,0,0,0,8333,8333,0
634,A,8326,8322,0,1,0,0,8322,4
634,A,8334,8333,0,0,0,0,8333,1
635,C,8333,0,8328,0,0,0,8328,5
635,G,8327,0,0,8320,0,2,8320,7
636,C,8334,0,8332,1,0,1,8332,2
636,G,8326,0,0,8325,0,1,8325,1
637,A,8336,8334,0,1,0,0,8334,2
637,T,8326,0,1,0,0,8325,8325,1
638,C,8327,0,8325,0,0,0,8325,2
638,T,8336,0,1,0,0,8335,8335,1
639,A,8316,8314,0,0,0,1,8314,2
639,C,8337,0,8331,0,0,1,8331,6
640,C,8337,1,8335,0,0,0,8335,2
640,G,8318,0,0,8305,0,2,8305,13
641,A,8336,8334,1,0,0,0,8334,2
641,G,8319,0,0,8319,0,0,8319,0
642,C,8338,1,8336,0,0,1,8336,2
642,G,8320,0,0,8319,0,0,8319,1
643,T,8320,0,1,0,0,8317,8317,3
643,T,8337,0,2,0,0,8334,8334,3
644,C,8338,1,8337,0,0,0,8337,1
644,G,8313,0,0,8311,0,0,8311,2
645,G,8314,1,0,8313,0,0,8313,1
645,G,8339,1,0,8338,0,0,8338,1
646,A,8340,8338,0,0,0,0,8338,2
646,T,8315,0,0,0,0,8314,8314,1
647,C,8315,1,8314,0,0,0,8314,1
647,C,8338,0,8335,0,0,2,8335,3
648,A,8315,8315,0,0,0,0,8315,0
648,A,8337,8335,1,0,0,0,8335,2
649,C,8315,1,8314,0,0,0,8314,1
649,C,8339,0,8337,0,0,2,8337,2
650,A,8340,8339,0,1,0,0,8339,1
650,G,8316,0,1,8314,0,0,8314,2
651,A,8315,8315,0,0,0,0,8315,0
651,C,8341,0,8305,0,0,1,8305,36
652,C,8340,1,8338,0,0,1,8338,2
652,G,8316,0,1,8301,0,1,8301,15
653,C,8341,0,8338,2,0,1,8338,3
653,G,8313,0,0,8311,0,2,8311,2
654,G,8312,1,0,8311,0,0,8311,1
654,G,8342,1,2,8338,0,0,8338,4
655,C,8343,0,8324,1,0,0,8324,19
655,T,8308,2,1,1,0,8301,8301,7
656,C,8343,1,8340,0,0,1,8340,3
656,G,8309,1,0,8288,0,0,8288,21
657,A,8342,8338,1,1,0,0,8338,4
657,G,8309,1,0,8308,0,0,8308,1
658,G,8310,1,0,8309,0,0,8309,1
658,G,8342,0,1,8341,0,0,8341,1
659,C,8311,0,8297,1,0,2,8297,14
659,C,8343,0,8341,0,0,2,8341,2
660,C,8311,1,8310,0,0,0,8310,1
660,G,8342,3,0,8328,0,0,8328,14
661,A,8305,8302,0,1,0,0,8302,3
661,G,8343,1,1,8340,0,0,8340,3
662,C,8343,0,8339,0,0,0,8339,4
662,G,8306,1,0,8284,0,1,8284,22
663,C,8345,1,8342,2,0,0,8342,3
663,G,8307,0,0,8307,0,0,8307,0
664,G,8308,1,0,8307,0,0,8307,1
664,G,8346,1,1,8343,0,0,8343,3
665,C,8308,0,8307,0,0,1,8307,1
665,C,8347,0,8347,0,0,0,8347,0
666,A,8300,8297,2,0,0,1,8297,3
666,A,8347,8343,1,2,0,1,8343,4
667,C,8300,1,8296,1,0,0,8296,4
667,T,8348,0,0,0,0,8345,8345,3
668,G,8301,0,1,8278,0,1,8278,23
668,G,8349,3,0,8339,0,0,8339,10
669,G,8302,0,1,8301,0,0,8301,1
669,G,8350,0,0,8350,0,0,8350,0
670,G,8302,0,0,8301,0,1,8301,1
670,T,8350,0,1,0,0,8348,8348,2
671,C,8302,0,8302,0,0,0,8302,0
671,G,8351,0,0,8350,0,0,8350,1
672,A,8299,8297,1,1,0,0,8297,2
672,A,8351,8351,0,0,0,0,8351,0
673,G,8300,1,0,8298,0,1,8298,2
673,G,8352,0,0,8350,0,1,8350,2
674,C,8301,0,8299,1,0,1,8299,2
674,C,8352,0,8349,0,0,3,8349,3
675,A,8352,8349,0,0,0,0,8349,3
675,T,8302,1,0,1,0,8295,8295,7
676,A,8353,8351,1,0,0,1,8351,2
676,T,8303,0,0,0,0,8303,8303,0
677,G,8304,1,0,8303,0,0,8303,1
677,G,8354,0,0,8337,0,0,8337,17
678,C,8305,0,8290,0,0,2,8290,15
678,G,8353,0,0,8353,0,0,8353,0
679,C,8305,1,8304,0,0,0,8304,1
679,G,8353,0,0,8352,0,0,8352,1
680,C,8348,0,8348,0,0,0,8348,0
680,G,8305,1,0,8299,0,0,8299,6
681,G,8306,1,0,8305,0,0,8305,1
681,G,8348,0,0,8346,0,0,8346,2
682,A,8349,8347,0,1,0,0,8347,2
682,T,8304,0,0,0,0,8304,8304,0
683,G,8304,1,0,8293,0,0,8293,11
683,G,8349,0,0,8339,0,0,8339,10
684,G,8305,1,0,8303,0,1,8303,2
684,G,8350,0,0,8350,0,0,8350,0
685,A,8349,8346,0,2,0,0,8346,3
685,T,8304,0,0,1,0,8303,8303,1
686,G,8305,1,0,8304,0,0,8304,1
686,G,8350,1,0,8348,0,0,8348,2
687,C,8306,1,8303,0,0,2,8303,3
687,C,8348,0,8347,0,0,0,8347,1
688,A,8306,8303,0,2,0,1,8303,3
688,T,8345,0,2,0,0,8343,8343,2
689,G,8307,1,0,8305,0,0,8305,2
689,G,8346,2,0,8344,0,0,8344,2
690,A,8308,8308,0,0,0,0,8308,0
690,T,8346,34,0,0,0,8309,8309,37
691,T,8308,0,2,0,0,8305,8305,3
691,T,8347,0,2,0,0,8345,8345,2
692,C,8348,0,8348,0,0,0,8348,0
692,G,8309,0,0,8309,0,0,8309,0
693,A,8309,8307,0,2,0,0,8307,2
693,A,8347,8344,0,0,0,0,8344,3
694,A,8310,8310,0,0,0,0,8310,0
694,C,8348,1,8305,0,0,34,8305,43
695,C,8311,0,8311,0,0,0,8311,0
695,C,8346,0,8340,3,0,0,8340,6
696,G,8342,1,2,8244,0,0,8244,98
696,T,8308,0,2,0,0,8300,8300,8
697,G,8346,0,0,8346,0,0,8346,0
697,T,8308,2,2,0,0,8304,8304,4
698,C,8308,0,8307,0,0,1,8307,1
698,G,8344,0,0,8343,0,0,8343,1
699,A,8307,8305,0,1,0,0,8305,2
699,G,8344,0,0,8308,0,36,8308,36
700,G,8308,0,1,8287,0,1,8287,21
700,T,8344,0,0,0,0,8343,8343,1
701,G,8309,1,1,8306,0,0,8306,3
701,G,8343,0,34,8307,0,0,8307,36
702,G,8309,0,0,8309,0,0,8309,0
702,G,8344,35,0,8308,0,1,8308,36
703,T,8306,0,1,0,0,8304,8304,2
703,T,8345,0,0,1,0,8343,8343,2
704,C,8305,0,8303,0,0,1,8303,2
704,G,8346,1,0,8345,0,0,8345,1
705,A,8306,8304,0,2,0,0,8304,2
705,C,8346,0,8331,0,0,1,8331,15
706,C,8346,0,8312,34,0,0,8312,34
706,G,8307,0,0,8307,0,0,8307,0
707,C,8307,0,8306,0,0,1,8306,1
707,C,8347,1,8345,0,0,1,8345,2
708,A,8347,8313,0,0,0,34,8313,34
708,T,8308,0,0,0,0,8304,8304,4
709,T,8309,0,0,0,0,8309,8309,0
709,T,8348,0,1,0,0,8347,8347,1
710,C,8349,0,8347,0,0,0,8347,2
710,G,8310,1,0,8309,0,0,8309,1
711,C,8311,0,8301,0,0,1,8301,10
711,C,8346,34,8312,0,0,0,8312,34
712,C,8309,0,8308,0,0,1,8308,1
712,T,8343,34,1,0,0,8308,8308,35
713,G,8310,4,0,8306,0,0,8306,4
713,G,8343,1,0,8336,0,0,8336,7
714,G,8344,0,0,8344,0,0,8344,0
714,T,8310,1,0,1,0,8307,8307,3
715,A,8307,8305,0,0,0,0,8305,2
715,T,8344,0,1,0,0,8342,8342,2
716,C,8342,0,8306,34,0,2,8306,36
716,G,8308,1,0,8305,0,1,8305,3
717,G,8309,0,0,8309,0,0,8309,0
717,G,8342,0,34,8307,0,0,8307,35
718,A,8342,8342,0,0,0,0,8342,0
718,T,8310,0,0,1,0,8309,8309,1
719,G,8310,2,0,8303,0,0,8303,7
719,G,8343,0,34,8309,0,0,8309,34
720,C,8344,34,8310,0,0,0,8310,34
720,G,8309,2,0,8307,0,0,8307,2
721,C,8310,0,8307,0,0,2,8307,3
721,T,8345,0,0,0,0,8345,8345,0
722,A,8308,8307,0,1,0,0,8307,1
722,G,8346,1,0,8341,0,0,8341,5
723,G,8347,1,0,8346,0,0,8346,1
723,T,8309,0,1,0,0,8306,8306,3
724,A,8347,8345,0,1,0,0,8345,2
724,C,8307,0,8305,0,0,2,8305,2
725,C,8346,0,8308,34,0,1,8308,38
725,G,8307,2,0,8305,0,0,8305,2
726,C,8308,0,8285,0,0,1,8285,23
726,G,8341,0,0,8334,0,0,8334,7
727,C,8308,0,8308,0,0,0,8308,0
727,G,8342,1,0,8341,0,0,8341,1
728,C,8307,0,8306,0,0,1,8306,1
728,C,8344,0,8343,0,0,1,8343,1
729,G,8345,4,0,8308,0,33,8308,37
729,T,8307,0,1,0,0,8306,8306,1
730,A,8346,8312,34,0,0,0,8312,34
730,C,8308,0,8307,0,0,1,8307,1
731,C,8345,0,8344,0,0,1,8344,1
731,G,8309,1,0,8307,0,1,8307,2
732,C,8310,0,8293,0,0,1,8293,17
732,G,8345,3,0,8342,0,0,8342,3
733,C,8310,1,8309,0,0,0,8309,1
733,T,8345,0,0,0,0,8345,8345,0
734,A,8346,8296,0,34,0,0,8296,50
734,C,8301,0,8301,0,0,0,8301,0
735,A,8346,8345,1,0,0,0,8345,1
735,T,8298,0,2,0,0,8295,8295,3
736,A,8346,8346,0,0,0,0,8346,0
736,C,8298,0,8295,0,0,0,8295,3
737,C,8347,0,8346,0,0,1,8346,1
737,G,8299,0,0,8296,0,1,8296,3
738,C,8300,0,8293,0,0,0,8293,7
738,G,8345,0,0,8342,0,0,8342,3
739,C,8300,0,8298,0,0,2,8298,2
739,G,8344,1,0,8343,0,0,8343,1
740,C,8345,0,8341,1,0,1,8341,4
740,G,8300,0,0,8289,0,0,8289,11
741,C,8346,0,8346,0,0,0,8346,0
741,G,8301,1,0,8300,0,0,8300,1
742,A,8301,8299,0,0,0,0,8299,2
742,A,8346,8345,0,0,0,0,8345,1
743,C,8302,0,8302,0,0,0,8302,0
743,C,8347,0,8347,0,0,0,8347,0
744,A,8300,8299,0,1,0,0,8299,1
744,A,8347,8309,0,35,0,0,8309,38
745,A,8348,8347,0,0,0,1,8347,1
745,C,8300,0,8299,0,0,0,8299,1
746,G,8299,1,0,8298,0,0,8298,1
746,G,8349,0,0,8349,0,0,8349,0
747,C,8301,0,8301,0,0,0,8301,0
747,T,8350,0,0,0,0,8345,8345,5
748,T,8301,1,1,1,0,8297,8297,4
748,T,8349,0,0,0,0,8349,8349,0
749,C,8350,0,8350,0,0,0,8350,0
749,G,8302,1,0,8301,0,0,8301,1
750,A,8302,8297,0,0,0,0,8297,5
750,A,8351,8349,1,1,0,0,8349,2
751,A,8303,8302,0,1,0,0,8302,1
751,G,8352,0,0,8351,0,1,8351,1
752,C,8303,0,8302,0,0,0,8302,1
752,C,8351,1,8349,0,0,0,8349,2
753,G,8351,2,0,8348,0,0,8348,3
753,T,8301,1,0,0,0,8295,8295,6
754,T,8296,0,2,0,0,8294,8294,2
754,T,8347,35,0,0,0,8312,8312,35
755,G,8297,0,0,8296,0,0,8296,1
755,G,8347,0,0,8347,0,0,8347,0
756,T,8297,0,0,1,0,8296,8296,1
756,T,8348,0,1,0,0,8312,8312,36
757,C,8314,0,8303,0,0,0,8303,11
757,G,8298,1,0,8291,0,1,8291,7
758,C,8315,0,8311,0,0,3,8311,4
758,G,8299,0,0,8299,0,0,8299,0
759,C,8300,0,8292,0,0,0,8292,8
759,G,8349,0,0,8335,0,0,8335,14
760,C,8300,0,8299,1,0,0,8299,1
760,G,8347,1,0,8346,0,0,8346,1
761,C,8347,0,8343,0,0,1,8343,4
761,G,8301,0,0,8300,0,1,8300,1
762,G,8348,1,0,8347,0,0,8347,1
762,T,8300,1,0,2,0,8287,8287,13
763,A,8347,8346,0,1,0,0,8346,1
763,T,8301,0,0,1,0,8300,8300,1
764,G,8349,1,0,8331,0,0,8331,18
764,T,8301,1,1,0,0,8299,8299,2
765,A,8301,8299,0,1,0,1,8299,2
765,G,8353,1,0,8352,0,0,8352,1
766,C,8302,1,8301,0,0,0,8301,1
766,G,8353,0,1,8352,0,0,8352,1
767,C,8354,0,8353,0,0,0,8353,1
767,G,8302,1,0,8301,0,0,8301,1
768,G,8354,3,1,8350,0,0,8350,4
768,T,8303,0,0,0,0,8303,8303,0
769,A,8355,8353,0,1,0,0,8353,2
769,C,8303,0,8301,0,0,1,8301,2
770,G,8301,2,0,8299,0,0,8299,2
770,G,8356,0,0,8328,0,0,8328,28
771,C,8302,0,8300,0,0,0,8300,2
771,G,8357,0,0,8357,0,0,8357,0
772,C,8302,0,8302,0,0,0,8302,0
772,G,8357,0,1,8356,0,0,8356,1
773,C,8355,0,8354,0,0,1,8354,1
773,G,8303,3,1,8299,0,0,8299,4
774,G,8349,0,0,8315,0,0,8315,34
774,T,8303,0,0,0,0,8303,8303,0
775,A,8316,8315,0,1,0,0,8315,1
775,C,8303,0,8298,0,0,0,8298,5
776,C,8303,2,8301,0,0,0,8301,2
776,T,8350,0,36,1,0,8313,8313,37
777,A,8302,8301,1,0,0,0,8301,1
777,G,8351,0,2,8349,0,0,8349,2
778,C,8351,0,8342,0,0,0,8342,9
778,G,8303,0,0,8303,0,0,8303,0
779,C,8303,0,8300,0,0,3,8300,3
779,C,8351,0,8351,0,0,0,8351,0
780,A,8352,8318,0,0,0,0,8318,34
780,T,8303,0,1,0,0,8301,8301,2
781,C,8304,0,8303,0,0,1,8303,1
781,C,8352,0,8343,0,0,0,8343,9
782,C,8353,0,8351,0,0,1,8351,2
782,G,8303,1,0,8302,0,0,8302,1
783,A,8304,8304,0,0,0,0,8304,0
783,T,8352,0,0,0,0,8352,8352,0
784,A,8353,8352,0,0,0,0,8352,1
784,C,8304,0,8303,0,0,0,8303,1
785,C,8304,1,8301,0,0,2,8301,3
785,C,8354,0,8353,0,0,1,8353,1
786,A,8304,8301,0,2,0,1,8301,3
786,G,8355,1,0,8348,0,0,8348,7
787,G,8304,2,0,8296,0,1,8296,8
787,G,8356,0,0,8356,0,0,8356,0
788,C,8352,0,8352,0,0,0,8352,0
788,G,8305,0,0,8305,0,0,8305,0
789,A,8306,8305,0,0,0,0,8305,1
789,A,8348,8346,0,0,0,0,8346,2
790,A,8349,8315,34,0,0,0,8315,34
790,T,8303,0,0,1,0,8302,8302,1
791,G,8302,0,0,8292,0,0,8292,10
791,G,8350,1,34,8315,0,0,8315,35
792,C,8351,0,8348,0,0,2,8348,3
792,G,8299,0,0,8299,0,0,8299,0
793,G,8300,0,0,8300,0,0,8300,0
793,T,8349,34,0,0,0,8315,8315,34
794,C,8300,0,8299,0,0,1,8299,1
794,G,8349,1,0,8348,0,0,8348,1
795,A,8300,8300,0,0,0,0,8300,0
795,A,8350,8350,0,0,0,0,8350,0
796,C,8300,1,8294,0,0,1,8294,6
796,C,8351,0,8338,0,0,0,8338,13
797,C,8297,1,8294,0,0,1,8294,3
797,C,8349,0,8349,0,0,0,8349,0
798,A,8294,8293,1,0,0,0,8293,1
798,C,8351,0,8351,0,0,0,8351,0
799,C,8296,1,8215,0,0,0,8215,81
799,T,8350,0,0,0,0,8350,8350,0
800,C,8292,1,8291,0,0,0,8291,1
800,G,8351,1,0,8350,0,0,8350,1
801,A,8352,8347,0,0,0,0,8347,5
801,C,8292,0,8290,0,0,2,8290,2
802,A,8352,8352,0,0,0,0,8352,0
802,C,8289,0,8287,0,0,0,8287,2
803,G,8287,0,0,8278,0,1,8278,9
803,G,8353,0,0,8353,0,0,8353,0
804,G,8290,0,0,8289,0,1,8289,1
804,T,8351,1,1,0,0,8313,8313,38
805,T,8289,0,0,0,0,8288,8288,1
805,T,8315,0,1,0,0,8314,8314,1
806,C,8316,0,8316,0,0,0,8316,0
806,G,8290,0,0,8290,0,0,8290,0
807,A,8287,8286,0,0,0,0,8286,1
807,A,8316,8312,0,2,0,0,8312,4
808,A,8285,8284,0,0,0,0,8284,1
808,T,8316,0,0,0,0,8316,8316,0
809,C,8285,0,8283,0,0,2,8283,2
809,C,8351,1,8315,34,0,1,8315,36
810,A,8276,8276,0,0,0,0,8276,0
810,T,8346,0,1,0,0,8345,8345,1
811,G,8277,1,0,8274,0,0,8274,3
811,G,8347,0,0,8347,0,0,8347,0
812,C,8276,0,8275,0,0,1,8275,1
812,C,8346,0,8309,0,0,2,8309,37
813,A,8346,8345,0,0,0,0,8345,1
813,T,8274,0,1,0,0,8273,8273,1
814,C,8275,0,8272,0,0,0,8272,3
814,C,8347,0,8338,0,0,0,8338,9
815,C,8271,0,8270,0,0,1,8270,1
815,C,8347,0,8346,0,0,1,8346,1
816,A,8347,8344,1,0,0,0,8344,3
816,T,8271,0,2,0,0,8269,8269,2
817,C,8272,0,8272,0,0,0,8272,0
817,C,8348,0,8306,32,0,0,8306,42
818,C,8345,1,8310,1,0,32,8310,35
818,G,8273,1,1,8271,0,0,8271,2
819,C,8274,0,8248,1,0,0,8248,26
819,G,8345,2,1,8328,0,0,8328,17
820,C,8274,0,8274,0,0,0,8274,0
820,G,8346,1,0,8345,0,0,8345,1
821,C,8265,1,8264,0,0,0,8264,1
821,C,8346,0,8346,0,0,0,8346,0
822,A,8349,8305,32,1,0,0,8305,44
822,T,8265,2,0,0,0,8259,8259,6
823,A,8348,8313,32,3,0,0,8313,35
823,T,8265,0,0,0,0,8265,8265,0
824,G,8266,0,1,8264,0,0,8264,2
824,G,8348,2,32,8313,0,0,8313,35
825,C,8267,0,8267,0,0,0,8267,0
825,C,8349,0,8346,3,0,0,8346,3
826,T,8268,0,0,0,0,8268,8268,0
826,T,8347,0,0,0,0,8347,8347,0
827,C,8269,0,8269,0,0,0,8269,0
827,G,8348,0,0,8348,0,0,8348,0
828,A,8253,8251,1,0,0,0,8251,2
828,C,8348,0,8322,2,0,3,8322,26
829,C,8254,1,8251,0,0,0,8251,3
829,C,8348,1,8346,0,0,1,8346,2
830,C,8253,0,8253,0,0,0,8253,0
830,C,8347,0,8347,0,0,0,8347,0
831,A,8254,8251,0,0,0,0,8251,3
831,G,8346,1,2,8308,0,33,8308,38
832,T,8252,0,0,1,0,8251,8251,1
832,T,8345,0,0,1,0,8344,8344,1
833,G,8249,0,0,8242,0,0,8242,7
833,G,8346,2,32,8311,0,0,8311,35
834,C,8347,0,8293,32,0,2,8293,54
834,G,8248,0,0,8247,0,0,8247,1
835,C,8349,0,8349,0,0,0,8349,0
835,T,8243,0,0,0,0,8243,8243,0
836,C,8343,0,8343,0,0,0,8343,0
836,G,8241,0,0,8239,0,1,8239,2
837,G,8241,0,0,8241,0,0,8241,0
837,T,8343,0,1,1,0,8340,8340,3
838,C,8223,0,8222,1,0,0,8222,1
838,G,8344,0,0,8335,0,1,8335,9
839,G,8224,0,0,8223,0,0,8223,1
839,G,8345,0,2,8342,0,1,8342,3
840,A,8221,8220,0,0,0,0,8220,1
840,C,8346,0,8287,32,0,1,8287,59
841,C,8222,0,8215,0,0,1,8215,7
841,C,8346,33,8313,0,0,0,8313,33
842,C,8221,1,8216,1,0,2,8216,5
842,C,8337,1,8333,0,0,2,8333,4
843,A,8335,8331,1,1,0,2,8331,4
843,G,8220,0,1,8214,0,0,8214,6
844,C,8337,0,8285,0,0,32,8285,52
844,G,8222,0,0,8222,0,0,8222,0
845,C,8338,1,8336,0,0,1,8336,2
845,T,8222,0,0,0,0,8221,8221,1
846,C,8223,0,8223,0,0,0,8223,0
846,C,8338,0,8337,0,0,1,8337,1
847,T,8223,0,0,0,0,8221,8221,2
847,T,8336,0,2,0,0,8334,8334,2
848,C,8225,0,8224,0,0,1,8224,1
848,C,8335,0,8300,0,0,1,8300,35
849,G,8336,2,0,8331,0,0,8331,5
849,T,8226,1,0,0,0,8222,8222,4
850,T,8225,0,0,0,0,8225,8225,0
850,T,8337,0,0,2,0,8335,8335,2
851,G,8226,2,0,8224,0,0,8224,2
851,G,8337,2,0,8303,0,0,8303,34
852,A,8304,8304,0,0,0,0,8304,0
852,T,8221,0,0,0,0,8220,8220,1
853,A,8219,8218,0,0,0,0,8218,1
853,C,8333,0,8326,0,0,0,8326,7
854,C,8220,0,8219,0,0,1,8219,1
854,C,8332,0,8330,0,0,1,8330,2
855,A,8179,8177,0,1,0,0,8177,2
855,A,8323,8290,32,0,0,0,8290,33
856,C,8324,0,8317,0,0,2,8317,7
856,G,8180,0,1,8179,0,0,8179,1
857,C,8160,0,8160,0,0,0,8160,0
857,C,8324,0,8292,0,0,32,8292,32
858,C,8325,0,8325,0,0,0,8325,0
858,T,8160,0,1,0,0,8158,8158,2
859,C,8160,0,8159,1,0,0,8159,1
859,T,8319,0,0,0,0,8319,8319,0
860,G,8161,1,1,8158,0,1,8158,3
860,G,8320,0,32,8288,0,0,8288,32
861,A,8321,8317,1,0,0,2,8317,4
861,T,8162,0,0,0,0,8162,8162,0
862,C,8162,0,8155,0,0,1,8155,7
862,C,8321,0,8283,0,0,32,8283,38
863,C,8157,0,8156,0,0,1,8156,1
863,C,8321,0,8289,32,0,0,8289,32
864,A,8158,8155,0,2,0,0,8155,3
864,T,8314,0,1,0,0,8311,8311,3
865,A,8308,8307,0,0,0,0,8307,1
865,T,8156,1,0,0,0,8154,8154,2
866,C,8309,0,8308,1,0,0,8308,1
866,G,8157,0,0,8156,0,0,8156,1
867,C,8157,0,8149,0,0,1,8149,8
867,G,8308,0,1,8304,0,0,8304,4
868,C,8156,0,8156,0,0,0,8156,0
868,G,8309,1,0,8308,0,0,8308,1
869,C,8286,1,8283,0,0,0,8283,3
869,G,8156,1,1,8154,0,0,8154,2
870,C,8156,0,8146,1,0,1,8146,10
870,G,8287,3,2,8248,0,0,8248,39
871,C,8157,0,8155,0,0,2,8155,2
871,T,8286,0,3,0,0,8283,8283,3
872,G,8157,0,0,8143,0,0,8143,14
872,G,8287,1,32,8252,0,0,8252,35
873,C,8288,0,8288,0,0,0,8288,0
873,G,8158,0,0,8157,0,0,8157,1
874,A,8286,8285,0,1,0,0,8285,1
874,T,8157,0,3,1,0,8150,8150,7
875,G,8159,2,0,8137,0,1,8137,22
875,G,8287,0,0,8286,0,0,8286,1
876,G,8160,1,0,8158,0,0,8158,2
876,T,8285,0,0,33,0,8252,8252,33
877,A,8159,8159,0,0,0,0,8159,0
877,G,8286,1,32,8251,0,2,8251,35
878,C,8287,0,8285,0,0,2,8285,2
878,G,8161,3,0,8158,0,0,8158,3
879,T,8161,0,0,0,0,8160,8160,1
879,T,8280,2,1,0,0,8275,8275,5
880,G,8162,0,0,8159,0,0,8159,3
880,T,8280,32,1,0,0,8247,8247,33
881,C,8279,0,8275,2,0,2,8275,4
881,G,8162,1,0,8161,0,0,8161,1
882,A,8280,8245,0,1,0,34,8245,35
882,C,8159,1,8156,1,0,1,8156,3
883,G,8160,1,2,8153,0,0,8153,7
883,G,8282,2,0,8279,0,0,8279,3
884,C,8282,32,8232,0,0,1,8232,50
884,G,8161,1,0,8159,0,0,8159,2
885,C,8161,0,8130,0,0,3,8130,31
885,C,8283,32,8249,2,0,0,8249,34
886,C,8163,0,8162,0,0,1,8162,1
886,G,8277,1,0,8276,0,0,8276,1
887,C,8164,1,8162,0,0,0,8162,2
887,C,8275,0,8272,0,0,0,8272,3
888,T,8161,1,0,0,0,8159,8159,2
888,T,8275,0,0,0,0,8241,8241,34
889,A,8276,8271,1,1,0,0,8271,5
889,C,8162,0,8161,0,0,0,8161,1
890,C,8277,1,8198,0,0,3,8198,79
890,G,8160,1,0,8148,0,0,8148,12
891,C,8277,0,8276,0,0,0,8276,1
891,G,8162,0,0,8162,0,0,8162,0
892,C,8162,1,8159,0,0,2,8159,3
892,C,8275,3,8269,1,0,2,8269,6
893,C,8266,3,8259,2,0,2,8259,7
893,G,8160,1,0,8158,0,0,8158,2
894,C,8156,0,8155,0,0,1,8155,1
894,G,8267,2,2,8263,0,0,8263,4
895,A,8266,8232,32,2,0,0,8232,34
895,G,8156,0,0,8156,0,0,8156,0
896,C,8267,1,8259,0,0,0,8259,8
896,T,8157,0,0,0,0,8156,8156,1
897,C,8264,0,8231,32,0,1,8231,33
897,T,8158,0,0,0,0,8158,8158,0
898,A,8256,8256,0,0,0,0,8256,0
898,C,8159,0,8158,0,0,1,8158,1
899,C,8257,0,8255,0,0,0,8255,2
899,G,8160,3,0,8157,0,0,8157,3
900,A,8256,8252,0,3,0,0,8252,4
900,T,8161,0,0,0,0,8161,8161,0
901,A,8160,8160,0,0,0,0,8160,0
901,T,8257,0,2,0,0,8254,8254,3
902,C,8160,0,8158,0,0,0,8158,2
902,G,8257,0,0,8225,0,0,8225,32
903,A,8222,8218,0,2,0,0,8218,4
903,T,8132,1,0,0,0,8131,8131,1
904,A,8222,8219,0,3,0,0,8219,3
904,G,8133,1,0,8131,0,0,8131,2
905,G,8222,0,0,8221,0,0,8221,1
905,T,8124,0,0,0,0,8119,8119,5
906,C,8253,0,8252,0,0,1,8252,1
906,T,8123,0,0,0,0,8123,8123,0
907,A,8236,8205,0,0,0,0,8205,31
907,C,8124,0,8121,0,0,2,8121,3
908,C,8121,0,8121,0,0,0,8121,0
908,G,8206,0,2,8204,0,0,8204,2
909,A,8122,8119,0,1,0,1,8119,3
909,C,8238,0,8238,0,0,0,8238,0
910,A,8238,8204,34,0,0,0,8204,34
910,C,8122,0,8122,0,0,0,8122,0
911,C,8239,1,8238,0,0,0,8238,1
911,G,8124,2,0,8119,0,1,8119,5
912,A,8125,8123,0,1,0,0,8123,2
912,G,8237,0,0,8237,0,0,8237,0
913,A,8238,8233,1,1,0,0,8233,5
913,T,8088,0,0,0,0,8088,8088,0
914,C,8237,1,8236,0,0,0,8236,1
914,G,8089,0,0,8083,0,0,8083,6
915,G,8090,1,0,8089,0,0,8089,1
915,T,8238,1,1,0,0,8235,8235,3
916,T,8091,0,0,1,0,8090,8090,1
916,T,8238,32,0,0,0,8206,8206,32
917,C,8239,0,8238,0,0,1,8238,1
917,G,8093,2,0,8090,0,0,8090,3
918,T,8092,0,1,0,0,8087,8087,5
918,T,8239,1,0,0,0,8233,8233,6
919,A,8090,8087,0,0,0,0,8087,3
919,T,8239,0,0,0,0,8239,8239,0
920,C,8239,1,8206,32,0,0,8206,33
920,G,8090,0,0,8090,0,0,8090,0
921,A,8238,8237,0,0,0,0,8237,1
921,T,8079,1,0,0,0,8078,8078,1
922,A,8235,8233,0,2,0,0,8233,2
922,C,8080,0,8074,0,0,1,8074,6
923,C,8068,0,8067,0,0,1,8067,1
923,G,8236,0,0,8236,0,0,8236,0
924,T,8051,0,1,0,0,8050,8050,1
924,T,8235,0,0,0,0,8202,8202,33
925,C,8052,0,8052,0,0,0,8052,0
925,C,8238,0,8218,0,0,1,8218,20
926,C,8235,0,8203,0,0,32,8203,32
926,G,8053,0,0,8051,0,1,8051,2
927,G,8236,0,0,8235,0,0,8235,1
927,T,8054,0,0,1,0,8049,8049,5
928,C,8236,2,8223,0,0,3,8223,13
928,T,8055,0,0,0,0,8054,8054,1
929,C,8236,0,8236,0,0,0,8236,0
929,G,8053,1,0,8051,0,0,8051,2
930,A,8237,8204,1,0,0,32,8204,33
930,T,8050,0,0,0,0,8050,8050,0
931,G,8050,1,0,8018,0,0,8018,32
931,T,8237,1,0,0,0,8235,8235,2
932,G,8050,1,0,8049,0,0,8049,1
932,G,8238,0,33,8204,0,1,8204,34
933,C,8239,1,8211,0,0,1,8211,28
933,G,8050,0,0,8050,0,0,8050,0
934,A,8044,8043,0,1,0,0,8043,1
934,C,8239,0,8239,0,0,0,8239,0
935,C,8238,0,8235,0,0,1,8235,3
935,G,8044,2,0,8033,0,0,8033,11
936,G,8044,1,0,8043,0,0,8043,1
936,G,8236,1,0,8235,0,0,8235,1
937,A,8238,8226,0,1,0,2,8226,12
937,T,8042,0,1,1,0,8039,8039,3
938,A,8240,8204,0,33,0,1,8204,36
938,G,8036,3,0,8032,0,1,8032,4
939,A,8037,8037,0,0,0,0,8037,0
939,G,8239,0,0,8234,0,0,8234,5
940,G,8240,0,0,8240,0,0,8240,0
940,T,8039,0,1,1,0,8037,8037,2
941,C,8242,0,8241,0,0,0,8241,1
941,G,8040,1,0,8039,0,0,8039,1
942,T,8040,1,0,0,0,8039,8039,1
942,T,8230,0,0,0,0,8230,8230,0
943,A,8231,8198,0,1,0,0,8198,33
943,C,8040,0,8038,0,0,1,8038,2
944,C,8041,0,8041,0,0,0,8041,0
944,C,8199,1,8196,0,0,1,8196,3
945,A,8037,8034,0,0,0,0,8034,3
945,G,8200,2,0,8195,0,2,8195,5
946,A,8038,8037,0,0,0,1,8037,1
946,T,8233,0,0,0,0,8233,8233,0
947,C,8039,0,8038,0,0,0,8038,1
947,C,8233,0,8218,0,0,0,8218,15
948,C,8230,32,8197,0,0,1,8197,33
948,T,8038,1,0,0,0,8032,8032,6
949,A,8229,8229,0,0,0,0,8229,0
949,T,8037,0,0,0,0,8037,8037,0
950,G,8033,0,0,8033,0,0,8033,0
950,G,8232,0,0,8226,0,0,8226,6
951,A,8033,8032,0,1,0,0,8032,1
951,G,8233,2,0,8231,0,0,8231,2
952,A,8223,8223,0,0,0,0,8223,0
952,T,8034,0,1,0,0,8033,8033,1
953,G,8035,0,0,8035,0,0,8035,0
953,G,8223,0,0,8223,0,0,8223,0
954,C,8176,1,8173,0,0,0,8173,3
954,T,8035,0,0,0,0,8032,8032,3
955,G,8176,2,0,8171,0,1,8171,5
955,T,8030,0,3,0,0,8027,8027,3
956,C,8175,0,8173,0,0,2,8173,2
956,G,8031,1,0,8030,0,0,8030,1
957,A,8032,8031,0,1,0,0,8031,1
957,A,8176,8140,2,32,0,1,8140,36
958,C,8033,1,8030,0,0,2,8030,3
958,C,8177,0,8139,0,0,34,8139,38
959,C,8174,0,8142,32,0,0,8142,32
959,G,8031,1,0,8030,0,0,8030,1
960,A,8175,8172,1,1,0,0,8172,3
960,T,8026,0,0,2,0,8018,8018,8
961,T,8026,1,0,0,0,8024,8024,2
961,T,8177,0,0,0,0,8177,8177,0
962,C,8177,0,8143,34,0,0,8143,34
962,G,8026,1,0,8025,0,0,8025,1
963,T,8025,0,0,0,0,8025,8025,0
963,T,8176,32,0,0,0,8137,8137,39
964,A,8025,8025,0,0,0,0,8025,0
964,T,8175,32,2,0,0,8141,8141,34
965,C,8176,0,8175,0,0,1,8175,1
965,G,8026,0,0,8019,0,0,8019,7
966,G,8026,0,0,8025,0,1,8025,1
966,T,8175,0,0,0,0,8170,8170,5
967,C,8022,1,8016,4,0,0,8016,6
967,T,8174,0,0,0,0,8174,8174,0
968,C,8174,0,8174,0,0,0,8174,0
968,G,8021,2,4,8014,0,0,8014,7
969,A,8163,8122,0,33,0,0,8122,41
969,C,8021,0,8014,0,0,1,8014,7
970,A,8162,8159,0,2,0,1,8159,3
970,C,8020,0,8018,1,0,0,8018,2
971,G,8019,0,2,7975,0,0,7975,44
971,G,8161,0,0,8146,0,2,8146,15
972,G,8021,1,0,8019,0,1,8019,2
972,G,8163,0,1,8162,0,0,8162,1
973,A,8161,8158,2,0,0,0,8158,3
973,G,8021,1,0,8020,0,0,8020,1
974,C,8022,0,8021,0,0,1,8021,1
974,C,8156,0,8154,1,0,1,8154,2
975,A,8022,8021,0,1,0,0,8021,1
975,G,8156,0,1,8155,0,0,8155,1
976,A,8157,8125,0,32,0,0,8125,32
976,G,8023,0,0,8021,0,0,8021,2
977,C,8024,0,8024,0,0,0,8024,0
977,C,8158,0,8152,2,0,4,8152,6
978,G,8158,1,0,8156,0,0,8156,2
978,T,8021,1,1,1,0,8017,8017,4
979,G,8022,0,0,8021,0,1,8021,1
979,G,8159,2,0,8157,0,0,8157,2
980,C,8019,0,8017,0,0,1,8017,2
980,C,8160,0,8158,0,0,0,8158,2
981,A,8019,8013,1,2,0,1,8013,6
981,A,8159,8122,0,1,0,0,8122,37
982,A,8128,8128,0,0,0,0,8128,0
982,C,8019,0,8018,1,0,0,8018,1
983,C,8162,0,8130,32,0,0,8130,32
983,G,8019,0,1,7988,0,2,7988,31
984,G,8020,0,0,8020,0,0,8020,0
984,T,8163,0,1,0,0,8159,8159,4
985,A,8162,8128,0,0,0,2,8128,34
985,G,8020,1,0,8019,0,0,8019,1
986,C,8017,0,8017,0,0,0,8017,0
986,C,8162,0,8128,31,0,1,8128,34
987,A,8159,8124,0,32,0,0,8124,35
987,T,8018,0,1,0,0,8015,8015,3
988,A,8159,8127,0,0,0,32,8127,32
988,T,8018,0,0,0,0,8018,8018,0
989,C,8018,0,8018,0,0,0,8018,0
989,G,8159,0,0,8159,0,0,8159,0
990,A,8160,8159,1,0,0,0,8159,1
990,T,8018,1,0,0,0,8009,8009,9
991,C,8158,0,8142,0,0,0,8142,16
991,T,8019,0,0,0,0,8019,8019,0
992,C,8133,0,8133,0,0,0,8133,0
992,G,8020,0,0,8000,0,2,8000,20
993,C,8132,0,8097,1,0,1,8097,35
993,G,8005,0,0,8004,0,0,8004,1
994,C,8005,0,8004,1,0,0,8004,1
994,G,8101,0,1,8096,0,0,8096,5
995,C,7996,0,7995,0,0,1,7995,1
995,C,8103,0,8102,0,0,0,8102,1
996,G,8104,1,0,8099,0,1,8099,5
996,T,7999,2,0,0,0,7994,7994,5
997,C,8105,0,8096,1,0,0,8096,9
997,T,8000,0,2,0,0,7998,7998,2
998,C,8101,1,8100,0,0,0,8100,1
998,G,8001,1,0,8000,0,0,8000,1
999,G,8100,3,0,8097,0,0,8097,3
999,T,8000,0,0,0,0,8000,8000,0
1000,A,8001,7999,0,2,0,0,7999,2
1000,A,8100,8097,0,1,0,2,8097,3
1001,G,8000,1,0,7994,0,0,7994,6
1001,G,8101,1,0,8095,0,1,8095,6
1002,G,7995,0,0,7995,0,0,7995,0
1002,G,8134,4,0,8130,0,0,8130,4
1003,T,7986,0,1,1,0,7984,7984,2
1003,T,8134,0,0,0,0,8134,8134,0
1004,G,7987,1,0,7981,0,1,7981,6
1004,G,8135,0,0,8135,0,0,8135,0
1005,A,8136,8133,0,1,0,0,8133,3
1005,G,7999,0,0,7999,0,0,7999,0
1006,A,8137,8103,0,0,0,2,8103,34
1006,T,7997,0,0,1,0,7995,7995,2
1007,C,7997,0,7996,0,0,1,7996,1
1007,G,8106,1,2,8103,0,0,8103,3
1008,T,7996,0,1,0,0,7990,7990,6
1008,T,8105,0,0,0,0,8100,8100,5
1009,T,7995,0,1,0,0,7994,7994,1
1009,T,8137,0,33,0,0,8104,8104,33
1010,C,8134,0,8132,0,0,1,8132,2
1010,G,8000,0,0,8000,0,0,8000,0
1011,A,8001,8001,0,0,0,0,8001,0
1011,G,8135,2,32,8101,0,0,8101,34
1012,A,8135,8134,0,1,0,0,8134,1
1012,C,8002,1,7998,0,0,1,7998,4
1013,C,8001,3,7998,0,0,0,7998,3
1013,G,8136,0,0,8107,0,2,8107,29
1014,G,8133,0,0,8133,0,0,8133,0
1014,T,7979,0,0,0,0,7978,7978,1
1015,C,7982,0,7982,0,0,0,7982,0
1015,G,8133,35,0,8098,0,0,8098,35
1016,A,7982,7981,0,1,0,0,7981,1
1016,C,8131,0,8130,0,0,1,8130,1
1017,G,8000,0,0,8000,0,0,8000,0
1017,G,8133,0,0,8101,0,32,8101,32
1018,A,8134,8097,32,3,0,0,8097,37
1018,C,7999,1,7997,0,0,1,7997,2
1019,C,8133,0,8130,0,0,3,8130,3
1019,G,7996,2,0,7994,0,0,7994,2
1020,A,8135,8098,2,3,0,32,8098,37
1020,T,7999,0,0,0,0,7999,7999,0
1021,C,7994,0,7994,0,0,0,7994,0
1021,C,8136,0,8116,2,0,0,8116,20
1022,C,8134,0,8133,0,0,1,8133,1
1022,G,8000,1,0,7999,0,0,7999,1
1023,C,8133,0,8130,2,0,1,8130,3
1023,T,8000,0,0,0,0,8000,8000,0
1024,A,8000,8000,0,0,0,0,8000,0
1024,T,8131,0,2,1,0,8128,8128,3
1025,G,8001,2,0,7999,0,0,7999,2
1025,G,8132,1,0,8127,0,0,8127,5
1026,G,8132,0,32,8100,0,0,8100,32
1026,T,7993,0,0,0,0,7993,7993,0
1027,G,7993,0,0,7988,0,0,7988,5
1027,T,8131,32,0,0,0,8099,8099,32
1028,G,7987,4,1,7982,0,0,7982,5
1028,G,8130,0,0,8130,0,0,8130,0
1029,A,8122,8088,0,32,0,0,8088,34
1029,C,7983,0,7980,0,0,0,7980,3
1030,A,8113,8113,0,0,0,0,8113,0
1030,C,7982,0,7982,0,0,0,7982,0
1031,C,8114,2,8106,0,0,0,8106,8
1031,G,7981,3,1,7977,0,0,7977,4
1032,C,7993,1,7988,1,0,0,7988,5
1032,C,8104,0,8071,32,0,0,8071,33
1033,C,7993,0,7992,0,0,0,7992,1
1033,G,8104,0,0,8104,0,0,8104,0
1034,C,8104,0,8071,0,0,0,8071,33
1034,G,7999,1,0,7998,0,0,7998,1
1035,A,8071,8070,0,0,0,0,8070,1
1035,T,8001,0,0,0,0,8000,8000,1
1036,C,8002,0,8000,0,0,1,8000,2
1036,T,8072,0,0,1,0,8071,8071,1
1037,C,8103,1,8098,1,0,1,8098,5
1037,T,8002,0,2,0,0,7988,7988,14
1038,G,8104,0,0,8103,0,0,8103,1
1038,T,8003,2,1,0,0,8000,8000,3
1039,A,8103,8103,0,0,0,0,8103,0
1039,T,8003,0,0,0,0,8003,8003,0
1040,C,8003,0,8002,0,0,1,8002,1
1040,G,8104,1,2,8101,0,0,8101,3
1041,A,7998,7996,0,1,0,1,7996,2
1041,C,8105,1,8071,0,0,32,8071,34
1042,G,8000,0,0,7999,0,0,7999,1
1042,T,8101,0,0,0,0,8099,8099,2
1043,C,7999,0,7998,0,0,1,7998,1
1043,G,8100,0,0,8067,0,1,8067,33
1044,A,8069,8062,2,2,0,0,8062,7
1044,T,7989,0,0,0,0,7987,7987,2
1045,A,8069,8069,0,0,0,0,8069,0
1045,T,7986,1,0,0,0,7985,7985,1
1046,C,7985,0,7985,0,0,0,7985,0
1046,G,8070,0,0,8052,0,2,8052,18
1047,A,7988,7985,0,2,0,0,7985,3
1047,G,8059,0,0,8058,0,1,8058,1
1048,G,8000,0,0,7999,0,0,7999,1
1048,G,8055,4,1,8050,0,0,8050,5
1049,C,7999,0,7990,0,0,0,7990,9
1049,C,8085,0,8085,0,0,0,8085,0
1050,A,8086,8083,0,0,0,1,8083,3
1050,C,7997,0,7996,0,0,1,7996,1
1051,T,7987,0,1,0,0,7986,7986,1
1051,T,8087,1,0,0,0,8083,8083,4
1052,C,7999,0,7999,0,0,0,7999,0
1052,C,8085,0,8053,0,0,0,8053,32
1053,G,8054,1,0,8051,0,0,8051,3
1053,T,8000,0,1,0,0,7999,7999,1
1054,A,8053,8053,0,0,0,0,8053,0
1054,G,8002,1,0,8001,0,0,8001,1
1055,C,8003,0,8003,0,0,0,8003,0
1055,C,8088,0,8088,0,0,0,8088,0
1056,T,8003,1,1,0,0,7999,7999,4
1056,T,8086,0,0,0,0,8084,8084,2
1057,T,7995,0,1,0,0,7994,7994,1
1057,T,8087,32,2,0,0,8053,8053,34
1058,C,8088,0,8088,0,0,0,8088,0
1058,G,7998,0,0,7997,0,0,7997,1
1059,A,7999,7997,0,1,0,0,7997,2
1059,A,8089,8081,2,0,0,0,8081,8
1060,A,8090,8086,0,1,0,3,8086,4
1060,T,8000,1,0,0,0,7999,7999,1
1061,C,7989,0,7987,0,0,1,7987,2
1061,G,8090,0,0,8081,0,1,8081,9
1062,G,8091,0,2,8089,0,0,8089,2
1062,T,7989,0,1,0,0,7988,7988,1
1063,A,8077,8044,1,0,0,32,8044,33
1063,C,7988,0,7987,0,0,0,7987,1
1064,G,7988,0,0,7987,0,0,7987,1
1064,G,8074,1,0,8065,0,0,8065,9
1065,C,7999,0,7965,0,0,0,7965,34
1065,G,8073,32,0,8041,0,0,8041,32
1066,A,8072,8072,0,0,0,0,8072,0
1066,C,8000,0,7999,0,0,1,7999,1
1067,C,7998,1,7996,0,0,1,7996,2
1067,C,8071,0,8039,0,0,0,8039,32
1068,G,8038,1,0,8034,0,1,8034,4
1068,T,7997,0,0,0,0,7996,7996,1
1069,G,8071,2,0,8069,0,0,8069,2
1069,T,7999,0,2,0,0,7997,7997,2
1070,C,7999,0,7999,0,0,0,7999,0
1070,C,8072,0,8071,0,0,0,8071,1
1071,A,7999,7997,1,1,0,0,7997,2
1071,A,8069,8030,0,2,0,0,8030,39
1072,A,8038,8038,0,0,0,0,8038,0
1072,G,8000,0,0,7968,0,0,7968,32
1073,C,8037,1,8035,0,0,1,8035,2
1073,G,8000,0,1,7999,0,0,7999,1
1074,A,8033,8032,0,0,0,0,8032,1
1074,G,7998,0,0,7998,0,0,7998,0
1075,C,7994,0,7992,0,0,1,7992,2
1075,T,8066,2,1,0,0,8063,8063,3
1076,C,8064,0,8024,32,0,0,8024,40
1076,G,7985,1,0,7983,0,1,7983,2
1077,C,7986,0,7984,0,0,0,7984,2
1077,C,8065,0,8064,0,0,0,8064,1
1078,C,7984,0,7982,0,0,2,7982,2
1078,T,8061,2,1,0,0,8026,8026,35
1079,G,7999,1,0,7997,0,0,7997,2
1079,G,8062,1,0,7991,0,0,7991,71
1080,G,8063,0,32,8031,0,0,8031,32
1080,T,8000,0,0,0,0,8000,8000,0
1081,C,8001,0,7988,0,0,0,7988,13
1081,G,8062,0,0,8060,0,2,8060,2
1082,C,8002,1,8000,0,0,0,8000,2
1082,G,8061,4,1,8056,0,0,8056,5
1083,C,8045,1,8040,0,0,1,8040,5
1083,T,8000,1,0,0,0,7998,7998,2
1084,A,8041,8040,0,1,0,0,8040,1
1084,C,8002,0,8002,0,0,0,8002,0
1085,C,8042,0,8041,0,0,0,8041,1
1085,G,8001,0,0,7925,0,0,7925,76
1086,A,8043,8006,33,0,0,0,8006,37
1086,G,8001,1,0,8000,0,0,8000,1
1087,A,8044,8040,0,1,0,3,8040,4
1087,G,8002,0,0,8002,0,0,8002,0
1088,G,8000,0,0,7998,0,2,7998,2
1088,G,8045,32,0,8013,0,0,8013,32
1089,C,8044,0,8044,0,0,0,8044,0
1089,T,7996,0,0,0,0,7996,7996,0
1090,A,7994,7994,0,0,0,0,7994,0
1090,T,8039,0,0,0,0,8039,8039,0
1091,C,7999,0,7999,0,0,0,7999,0
1091,G,8038,0,0,8000,0,1,8000,38
1092,A,7998,7998,0,0,0,0,7998,0
1092,G,8007,0,0,8006,0,1,8006,1
1093,A,8008,8005,1,1,0,0,8005,3
1093,T,7998,0,1,0,0,7997,7997,1
1094,C,7999,0,7995,0,0,0,7995,4
1094,G,8007,1,0,8006,0,0,8006,1
1095,C,7949,0,7948,1,0,0,7948,1
1095,T,8035,0,2,1,0,8031,8031,4
1096,A,8020,7988,0,0,0,0,7988,32
1096,G,7985,0,0,7984,0,1,7984,1
1097,C,7982,1,7981,0,0,0,7981,1
1097,C,8021,1,8020,0,0,0,8020,1
1098,A,8018,7985,32,0,0,0,7985,33
1098,T,7978,0,0,0,0,7978,7978,0
1099,A,8019,7986,32,1,0,0,7986,33
1099,C,7985,0,7984,0,0,1,7984,1
1100,C,8017,0,8016,0,0,1,8016,1
1100,G,7983,2,0,7979,0,1,7979,4
1101,G,8000,1,0,7998,0,0,7998,2
1101,T,8013,0,0,1,0,8012,8012,1
1102,A,8000,7995,0,2,0,3,7995,5
1102,A,8014,7979,35,0,0,0,7979,35
1103,C,8010,0,8010,0,0,0,8010,0
1103,G,8001,1,0,7995,0,0,7995,6
1104,A,8008,7970,0,34,0,0,7970,38
1104,G,8000,0,0,8000,0,0,8000,0
1105,A,7998,7995,1,1,0,0,7995,3
1105,A,8008,8006,1,1,0,0,8006,2
1106,C,7997,0,7995,0,0,0,7995,2
1106,G,7997,0,0,7993,0,0,7993,4
1107,A,7993,7958,1,34,0,0,7958,35
1107,G,8000,1,0,7999,0,0,7999,1
1108,C,8000,0,7994,0,0,3,7994,6
1108,G,7998,1,0,7997,0,0,7997,1
1109,C,7991,0,7984,0,0,0,7984,7
1109,C,8000,0,8000,0,0,0,8000,0
1110,C,7995,0,7994,0,0,0,7994,1
1110,T,7991,0,1,0,0,7990,7990,1
1111,A,7995,7961,33,0,0,0,7961,34
1111,C,7993,0,7962,0,0,2,7962,31
1112,C,7992,0,7992,0,0,0,7992,0
1112,C,7997,0,7995,0,0,1,7995,2
1113,A,7996,7988,0,3,0,0,7988,8
1113,C,7993,0,7992,0,0,1,7992,1
1114,A,7998,15993,1,1,0,1,15993,-7995
1115,C,7999,1,7998,0,0,0,7998,1
1115,G,8000,0,0,7998,0,0,7998,2
1116,C,8000,0,7977,0,0,2,7977,23
1116,G,8000,1,0,7998,0,0,7998,2
1117,C,7997,1,7995,0,0,1,7995,2
1117,T,7992,1,1,1,0,7989,7989,3
1118,C,7984,0,7984,0,0,0,7984,0
1118,C,7998,1,7962,34,0,0,7962,36
1119,A,7977,7973,0,0,0,0,7973,4
1119,T,7998,0,1,0,0,7993,7993,5
1120,A,7997,7995,0,0,0,0,7995,2
1120,T,7983,0,0,0,0,7982,7982,1
1121,G,7987,1,0,7976,0,0,7976,11
1121,T,7998,1,1,34,0,7962,7962,36
1122,A,7999,7998,0,0,0,1,7998,1
1122,G,8000,1,0,7998,0,0,7998,2
1123,T,7999,0,1,0,0,7996,7996,3
1123,T,8000,1,37,0,0,7962,7962,38
1124,C,7957,0,7957,0,0,0,7957,0
1124,C,7982,0,7982,0,0,0,7982,0
1125,A,7881,7881,0,0,0,0,7881,0
1125,T,7981,0,1,0,0,7978,7978,3
1126,T,7875,0,1,0,0,7874,7874,1
1126,T,7988,0,2,0,0,7986,7986,2
1127,C,8000,2,7998,0,0,0,7998,2
1127,G,7875,0,0,7869,0,1,7869,6
1128,G,7878,3,1,7871,0,3,7871,7
1128,T,7998,0,1,0,0,7992,7992,6
1129,C,7877,1,7836,33,0,0,7836,41
1129,T,7997,1,3,0,0,7993,7993,4
1130,C,7873,1,7871,0,0,1,7871,2
1130,C,7999,0,7999,0,0,0,7999,0
1131,G,7871,1,0,7869,0,1,7869,2
1131,T,7979,0,0,0,0,7979,7979,0
1132,A,7871,7870,1,0,0,0,7870,1
1132,G,8000,0,0,8000,0,0,8000,0
1133,C,7874,0,7874,0,0,0,7874,0
1133,C,7997,0,7995,0,0,2,7995,2
1134,A,7886,7883,0,1,0,0,7883,3
1134,A,7996,7994,0,0,0,1,7994,2
1135,A,7889,7886,0,3,0,0,7886,3
1135,T,7998,0,0,2,0,7995,7995,3
1136,G,7906,1,0,7905,0,0,7905,1
1136,T,7991,0,0,0,0,7991,7991,0
1137,A,7994,7992,0,0,0,1,7992,2
1137,C,7921,0,7917,0,0,3,7917,4
1138,A,7919,7883,0,34,0,0,7883,36
1138,C,7995,0,7991,1,0,1,7991,4
1139,G,7938,0,0,7938,0,0,7938,0
1139,G,7988,1,1,7918,0,0,7918,70
1140,A,7938,7936,0,1,0,0,7936,2
1140,G,7993,0,1,7990,0,2,7990,3
1141,A,7937,7936,1,0,0,0,7936,1
1141,G,7980,0,0,7979,0,1,7979,1
1142,G,7945,0,0,7944,0,0,7944,1
1142,G,7986,2,0,7983,0,0,7983,3
1143,A,7942,7900,0,35,0,0,7900,42
1143,C,7986,0,7980,1,0,1,7980,6
1144,A,7941,7941,0,0,0,0,7941,0
1144,C,7983,0,7981,0,0,2,7981,2
1145,C,7942,0,7939,0,0,1,7939,3
1145,G,7999,1,0,7997,0,0,7997,2
1146,G,7933,0,0,7928,0,1,7928,5
1146,T,7999,1,1,0,0,7997,7997,2
1147,C,8001,0,7999,0,0,2,7999,2
1147,G,7986,2,0,7984,0,0,7984,2
1148,C,7979,0,7979,0,0,0,7979,0
1148,G,8001,3,0,7991,0,0,7991,10
1149,A,7985,7951,0,34,0,0,7951,34
1149,G,8001,0,0,8001,0,0,8001,0
1150,A,8000,7998,0,1,0,0,7998,2
1150,T,7985,0,35,0,0,7949,7949,36
1151,C,7985,0,7983,0,0,1,7983,2
1151,G,7998,0,0,7887,0,0,7887,111
1152,A,7991,7946,1,4,0,0,7946,45
1152,G,7999,1,0,7998,0,0,7998,1
1153,A,7964,7964,0,0,0,0,7964,0
1153,G,8001,0,1,8000,0,0,8000,1
1154,G,7965,1,0,7957,0,0,7957,8
1154,G,7996,0,0,7995,0,0,7995,1
1155,A,7992,7981,0,7,0,0,7981,11
1155,G,7997,1,34,7962,0,0,7962,35
1156,A,8000,7999,0,0,0,0,7999,1
1156,T,7984,0,0,0,0,7983,7983,1
1157,G,7985,0,0,7984,0,1,7984,1
1157,G,8000,0,0,7997,0,0,7997,3
1158,A,7984,7978,0,0,0,0,7978,6
1158,T,7996,0,1,1,0,7986,7986,10
1159,A,7999,7999,0,0,0,0,7999,0
1159,T,7997,0,0,0,0,7997,7997,0
1160,C,8000,0,7965,33,0,2,7965,35
1160,G,7995,1,0,7992,0,0,7992,3
1161,G,7998,1,1,7996,0,0,7996,2
1161,T,7998,0,1,34,0,7961,7961,37
1162,T,7996,0,1,0,0,7995,7995,1
1162,T,7998,0,0,34,0,7964,7964,34
1163,C,7996,0,7996,0,0,0,7996,0
1163,G,7996,1,0,7994,0,0,7994,2
1164,A,7996,7958,0,34,0,0,7958,38
1164,C,7996,1,7983,1,0,3,7983,13
1165,A,7999,7999,0,0,0,0,7999,0
1165,C,7988,0,7986,0,0,2,7986,2
1166,G,7994,2,0,7992,0,0,7992,2
1166,G,7999,0,0,7998,0,1,7998,1
1167,A,7998,7997,0,0,0,0,7997,1
1167,C,7996,0,7995,1,0,0,7995,1
1168,G,7996,3,0,7993,0,0,7993,3
1168,T,7994,0,0,0,0,7993,7993,1
1169,C,7983,0,7947,0,0,1,7947,36
1169,C,8000,0,7998,0,0,1,7998,2
1170,A,7996,7992,0,1,0,0,7992,4
1170,C,7955,4,7949,0,0,1,7949,6
1171,G,7956,0,1,7952,0,3,7952,4
1171,G,8000,0,0,8000,0,0,8000,0
1172,C,7965,0,7960,1,0,0,7960,5
1172,C,8000,1,7999,0,0,0,7999,1
1173,C,7999,1,7996,0,0,1,7996,3
1173,T,8001,0,2,0,0,7997,7997,4
1174,A,7999,7997,1,0,0,1,7997,2
1174,T,8002,0,0,0,0,8001,8001,1
1175,C,8001,0,7967,0,0,0,7967,34
1175,C,8002,0,8002,0,0,0,8002,0
1176,A,8000,7991,0,1,0,0,7991,9
1176,A,8003,8002,0,1,0,0,8002,1
1177,A,8000,7965,1,34,0,0,7965,35
1177,C,8005,0,8000,0,0,1,8000,5
1178,C,7998,0,7998,0,0,0,7998,0
1178,C,8001,0,8001,0,0,0,8001,0
1179,A,7998,7997,0,0,0,0,7997,1
1179,T,8000,0,1,0,0,7996,7996,4
1180,T,7986,0,1,0,0,7985,7985,1
1180,T,7998,0,1,0,0,7962,7962,36
1181,C,7961,0,7961,0,0,0,7961,0
1181,G,8000,0,0,7999,0,0,7999,1
1182,G,7998,0,0,7998,0,0,7998,0
1182,T,8000,0,0,0,0,8000,8000,0
1183,A,8000,8000,0,0,0,0,8000,0
1183,A,8001,8001,0,0,0,0,8001,0
1184,G,7999,0,0,7993,0,0,7993,6
1184,G,8002,0,0,8001,0,1,8001,1
1185,A,7998,7998,0,0,0,0,7998,0
1185,G,8000,1,0,7999,0,0,7999,1
1186,A,7997,7961,1,0,0,0,7961,36
1186,T,7990,0,0,0,0,7990,7990,0
1187,C,7996,0,7995,0,0,1,7995,1
1187,G,7997,2,0,7994,0,0,7994,3
1188,A,7990,7987,0,0,0,0,7987,3
1188,G,7994,2,0,7953,0,35,7953,41
1189,A,7990,7989,1,0,0,0,7989,1
1189,G,7999,4,0,7995,0,0,7995,4
1190,C,7994,0,7994,0,0,0,7994,0
1190,C,7998,34,7963,0,0,1,7963,35
1191,A,7999,7996,1,0,0,2,7996,3
1191,T,7986,1,0,0,0,7985,7985,1
1192,C,7986,0,7986,0,0,0,7986,0
1192,G,8000,1,0,7999,0,0,7999,1
1193,C,7993,1,7990,0,0,1,7990,3
1193,G,7984,0,0,7982,0,1,7982,2
1194,C,7989,0,7981,0,0,1,7981,8
1194,G,7999,0,0,7965,0,0,7965,34
1195,C,7989,0,7987,0,0,2,7987,2
1195,T,7999,0,0,1,0,7997,7997,2
1196,G,7999,1,0,7998,0,0,7998,1
1196,G,8000,1,0,7996,0,0,7996,4
1197,C,8000,34,7963,0,0,3,7963,37
1197,T,7998,1,0,0,0,7997,7997,1
1198,A,7996,7995,0,1,0,0,7995,1
1198,C,8000,1,7992,0,0,0,7992,8
1199,C,7997,1,7996,0,0,0,7996,1
1199,G,7999,0,0,7999,0,0,7999,0
1200,C,7996,0,7962,34,0,0,7962,34
1200,T,7997,1,2,0,0,7994,7994,3
1201,G,8000,1,0,7999,0,0,7999,1
1201,T,7997,34,0,1,0,7961,7961,36
1202,C,7997,0,7997,0,0,0,7997,0
1202,C,8001,0,7999,0,0,2,7999,2
1203,A,8002,8002,0,0,0,0,8002,0
1203,G,7988,2,0,7986,0,0,7986,2
1204,C,7988,1,7946,33,0,1,7946,42
1204,G,8003,0,0,7948,0,1,7948,55
1205,C,7987,0,7984,2,0,1,7984,3
1205,G,7986,0,0,7986,0,0,7986,0
1206,G,7995,1,0,7993,0,1,7993,2
1206,G,7999,2,0,7995,0,0,7995,4
1207,A,7992,7991,0,1,0,0,7991,1
1207,A,7999,7961,1,34,0,0,7961,38
1208,C,7998,1,7990,0,0,1,7990,8
1208,G,7980,0,0,7967,0,0,7967,13
1209,C,7999,2,7997,0,0,0,7997,2
1209,G,7979,0,0,7979,0,0,7979,0
1210,A,7967,7967,0,0,0,0,7967,0
1210,A,8000,7998,1,0,0,1,7998,2
1211,C,8001,1,7998,0,0,1,7998,3
1211,G,8000,0,0,8000,0,0,8000,0
1212,T,8000,0,0,0,0,7999,7999,1
1212,T,8002,0,0,0,0,8000,8000,2
1213,A,8004,8003,0,0,0,0,8003,1
1213,C,7999,0,7996,0,0,1,7996,3
1214,C,7999,0,7999,0,0,0,7999,0
1214,C,8004,0,8000,0,0,0,8000,4
1215,C,7997,0,7963,34,0,0,7963,34
1215,T,7994,1,0,0,0,7991,7991,3
1216,A,7993,7993,0,0,0,0,7993,0
1216,G,8000,1,0,7992,0,0,7992,8
1217,G,7997,0,1,7995,0,0,7995,2
1217,G,7999,0,0,7998,0,1,7998,1
1218,C,7998,0,7997,0,0,0,7997,1
1218,G,8000,1,0,7999,0,0,7999,1
1219,A,7981,7981,0,0,0,0,7981,0
1219,T,7996,0,1,0,0,7995,7995,1
1220,C,7943,0,7942,0,0,1,7942,1
1220,G,7996,0,0,7995,0,0,7995,1
1221,A,7943,7942,0,0,0,0,7942,1
1221,A,7981,7970,0,1,0,0,7970,11
1222,A,7983,7982,0,1,0,0,7982,1
1222,C,7952,0,7951,0,0,1,7951,1
1223,C,7986,1,7948,34,0,0,7948,38
1223,G,7956,1,1,7953,0,0,7953,3
1224,A,7964,7960,1,0,0,1,7960,4
1224,G,7962,0,0,7961,0,1,7961,1
1225,C,7983,0,7883,0,0,2,7883,100
1225,T,7962,0,1,0,0,7961,7961,1
1226,C,7970,0,7970,0,0,0,7970,0
1226,C,7980,0,7979,0,0,1,7979,1
1227,A,7967,7967,0,0,0,0,7967,0
1227,C,7991,36,7955,0,0,0,7955,36
1228,C,7983,0,7981,0,0,2,7981,2
1228,C,7988,0,7988,0,0,0,7988,0
1229,C,7983,0,7983,0,0,0,7983,0
1229,C,7985,0,7985,0,0,0,7985,0
1230,A,7986,7983,1,0,0,0,7983,3
1230,A,7989,7952,1,1,0,34,7952,37
1231,C,7980,0,7976,0,0,2,7976,4
1231,T,7989,34,0,0,0,7953,7953,36
1232,C,7989,0,7988,1,0,0,7988,1
1232,G,7974,2,2,7967,0,0,7967,7
1233,C,7974,0,7962,2,0,0,7962,12
1233,G,7990,1,0,7985,0,1,7985,5
1234,C,7976,0,7974,1,0,1,7974,2
1234,G,7995,0,0,7995,0,0,7995,0
1235,C,7997,0,7995,0,0,2,7995,2
1235,G,7976,1,1,7974,0,0,7974,2
1236,C,7976,0,7965,0,0,0,7965,11
1236,G,7993,1,35,7954,0,0,7954,39
1237,A,7992,7991,0,1,0,0,7991,1
1237,C,7975,1,7973,0,0,1,7973,2
1238,C,7990,34,7953,0,0,3,7953,37
1238,G,7978,1,0,7977,0,0,7977,1
1239,G,7992,1,1,7987,0,0,7987,5
1239,T,7994,0,0,0,0,7993,7993,1
1240,C,8000,0,7988,0,0,0,7988,12
1240,G,7998,0,4,7992,0,2,7992,6
1241,C,7999,0,7865,1,0,0,7865,134
1241,C,8001,0,8000,0,0,0,8000,1
1242,C,8000,0,8000,0,0,0,8000,0
1242,T,7999,0,0,1,0,7998,7998,1
1243,C,8000,0,7999,0,0,0,7999,1
1243,C,8001,0,8001,0,0,0,8001,0
1244,C,8001,0,8001,0,0,0,8001,0
1244,G,8000,1,0,7999,0,0,7999,1
1245,A,8001,7991,0,1,0,0,7991,10
1245,G,8003,1,0,8000,0,1,8000,3
1246,A,8001,8000,1,0,0,0,8000,1
1246,T,8001,0,1,0,0,8000,8000,1
1247,G,8001,1,0,8000,0,0,8000,1
1247,G,8002,1,0,8001,0,0,8001,1
1248,C,8003,1,7999,0,0,2,7999,4
1248,T,7996,0,0,1,0,7991,7991,5
1249,T,7987,34,1,0,0,7952,7952,35
1249,T,7989,0,0,0,0,7989,7989,0
1250,C,7996,0,7996,0,0,0,7996,0
1250,G,7992,1,0,7991,0,0,7991,1
1251,A,7996,7994,0,1,0,0,7994,2
1251,C,7989,0,7989,0,0,0,7989,0
1252,T,7982,0,0,0,0,7981,7981,1
1252,T,7996,0,1,0,0,7995,7995,1
1253,C,7996,0,7996,0,0,0,7996,0
1253,G,7996,0,0,7995,0,0,7995,1
1254,A,7996,7996,0,0,0,0,7996,0
1254,C,7987,0,7951,1,0,0,7951,36
1255,C,7992,0,7991,0,0,1,7991,1
1255,C,7996,0,7995,0,0,0,7995,1
1256,C,7993,0,7993,0,0,0,7993,0
1256,G,7995,2,0,7993,0,0,7993,2
1257,C,7997,0,7996,0,0,1,7996,1
1257,G,7998,0,1,7997,0,0,7997,1
1258,A,7999,7963,0,34,0,1,7963,36
1258,G,7996,2,0,7994,0,0,7994,2
1259,C,7996,0,7993,1,0,1,7993,3
1259,C,7999,1,7997,0,0,1,7997,2
1260,A,7996,7955,1,35,0,0,7955,41
1260,T,7995,0,0,1,0,7994,7994,1
1261,A,7998,7964,34,0,0,0,7964,34
1261,C,7999,0,7974,0,0,1,7974,25
1262,C,7994,0,7987,0,0,0,7987,7
1262,C,7999,1,7997,0,0,1,7997,2
1263,C,7995,0,7957,0,0,36,7957,38
1263,C,8000,0,7999,0,0,1,7999,1
1264,A,7992,7992,0,0,0,0,7992,0
1264,A,7999,7998,0,0,0,1,7998,1
1265,C,7998,0,7997,0,0,0,7997,1
1265,C,8001,1,8000,0,0,0,8000,1
1266,T,7996,34,0,0,0,7961,7961,35
1266,T,8000,0,0,0,0,7995,7995,5
1267,A,7999,7999,0,0,0,0,7999,0
1267,T,8000,0,1,0,0,7999,7999,1
1268,C,8000,0,7995,0,0,0,7995,5
1268,G,7992,0,0,7992,0,0,7992,0
1269,A,7992,7986,0,0,0,1,7986,6
1269,C,8001,1,7966,34,0,0,7966,35
1270,A,7988,7986,0,1,0,1,7986,2
1270,T,7976,0,0,1,0,7975,7975,1
1271,G,7976,0,0,7976,0,0,7976,0
1271,G,7995,0,0,7994,0,1,7994,1
1272,A,7969,7968,0,0,0,0,7968,1
1272,C,7976,0,7951,0,0,1,7951,25
1273,C,7997,0,7997,0,0,0,7997,0
1273,G,7969,2,0,7933,0,0,7933,36
1274,C,7925,0,7923,0,0,0,7923,2
1274,C,7995,2,7991,0,0,2,7991,4
1275,A,7934,7933,0,0,0,0,7933,1
1275,T,7995,0,2,0,0,7993,7993,2
1276,C,7938,0,7921,0,0,0,7921,17
1276,C,7999,1,7997,0,0,0,7997,2
1277,C,7918,1,7915,0,0,2,7915,3
1277,G,7999,0,0,7828,0,1,7828,171
1278,C,7953,1,7951,0,0,1,7951,2
1278,G,8000,0,0,8000,0,0,8000,0
1279,A,7995,7994,0,0,0,1,7994,1
1279,G,8000,0,0,8000,0,0,8000,0
1280,G,7999,0,0,7965,0,0,7965,34
1280,G,8000,0,0,7996,0,0,7996,4
1281,A,7996,7969,2,22,0,0,7969,27
1281,T,8000,0,0,0,0,7997,7997,3
1282,A,7990,7987,0,2,0,1,7987,3
1282,C,8000,0,7961,0,0,0,7961,39
1283,C,7996,0,7996,0,0,0,7996,0
1283,G,7996,1,0,7994,0,1,7994,2
1284,A,7991,7983,1,0,0,0,7983,8
1284,G,7998,0,0,7998,0,0,7998,0
1285,A,7992,7992,0,0,0,0,7992,0
1285,A,7996,7996,0,0,0,0,7996,0
1286,C,7997,0,7997,0,0,0,7997,0
1286,G,7999,0,0,7999,0,0,7999,0
1287,A,7977,7976,0,0,0,0,7976,1
1287,C,7999,0,7964,0,0,35,7964,35
1288,G,8000,1,0,7999,0,0,7999,1
1288,T,7955,0,0,0,0,7955,7955,0
1289,C,8001,0,7998,0,0,2,7998,3
1289,G,7976,1,0,7974,0,0,7974,2
1290,A,7976,7941,0,34,0,0,7941,35
1290,T,8002,0,0,0,0,7999,7999,3
1291,G,7994,36,0,7958,0,0,7958,36
1291,T,8001,0,0,0,0,8001,8001,0
1292,C,7994,0,7993,0,0,1,7993,1
1292,C,7998,0,7997,0,0,0,7997,1
1293,A,7988,7980,1,0,0,0,7980,8
1293,A,7998,7991,0,2,0,1,7991,7
1294,A,7988,7954,34,0,0,0,7954,34
1294,A,7998,7996,0,1,0,0,7996,2
1295,A,7980,7945,0,1,0,34,7945,35
1295,G,7999,2,0,7997,0,0,7997,2
1296,G,7984,0,0,7949,0,35,7949,35
1296,T,8001,1,0,0,0,8000,8000,1
1297,A,7949,7949,0,0,0,0,7949,0
1297,A,7987,7953,0,0,0,34,7953,34
1298,C,7991,0,7958,0,0,0,7958,33
1298,G,7987,1,0,7986,0,0,7986,1
1299,C,7986,0,7986,0,0,0,7986,0
1299,T,7991,0,0,0,0,7991,7991,0
1300,C,7991,0,7989,0,0,2,7989,2
1300,C,7993,0,7993,0,0,0,7993,0
1301,C,7993,1,7991,0,0,1,7991,2
1301,G,7992,0,0,7937,0,0,7937,55
1302,A,7998,7988,2,3,0,0,7988,10
1302,G,7991,0,0,7991,0,0,7991,0
1303,A,7998,7997,0,1,0,0,7997,1
1303,G,7993,0,0,7993,0,0,7993,0
1304,C,7998,0,7996,0,0,1,7996,2
1304,G,7992,2,0,7990,0,0,7990,2
1305,A,7993,7976,0,17,0,0,7976,17
1305,G,7996,2,0,7994,0,0,7994,2
1306,A,7995,7995,0,0,0,0,7995,0
1306,T,7992,0,0,0,0,7992,7992,0
1307,G,7987,0,0,7987,0,0,7987,0
1307,G,7995,2,0,7993,0,0,7993,2
1308,A,7987,7948,0,35,0,0,7948,39
1308,T,7995,0,0,0,0,7995,7995,0
1309,A,7988,7988,0,0,0,0,7988,0
1309,C,7999,0,7998,0,0,1,7998,1
1310,G,7997,0,0,7963,0,0,7963,34
1310,G,7998,0,0,7992,0,0,7992,6
1311,C,7958,0,7957,0,0,1,7957,1
1311,G,7998,0,0,7998,0,0,7998,0
1312,C,7996,1,7994,0,0,1,7994,2
1312,G,7959,1,1,7957,0,0,7957,2
1313,C,7991,0,7990,1,0,0,7990,1
1313,G,7998,0,0,7933,0,1,7933,65
1314,G,7991,0,0,7957,0,34,7957,34
1314,G,7999,0,0,7999,0,0,7999,0
1315,A,7999,7999,0,0,0,0,7999,0
1315,G,7998,0,0,7998,0,0,7998,0
1316,G,8000,0,0,7998,0,2,7998,2
1316,T,8000,0,0,0,0,7966,7966,34
1317,C,8001,0,8000,0,0,1,8000,1
1317,T,7992,0,0,1,0,7991,7991,1
1318,A,8002,8002,0,0,0,0,8002,0
1318,G,7999,1,0,7998,0,0,7998,1
1319,C,7999,0,7998,0,0,1,7998,1
1319,C,8003,0,8002,0,0,0,8002,1
1320,A,7999,7994,1,2,0,0,7994,5
1320,T,7995,0,3,0,0,7992,7992,3
1321,T,7995,1,0,1,0,7993,7993,2
1321,T,8000,0,2,0,0,7998,7998,2
1322,C,8000,0,7998,0,0,1,7998,2
1322,G,7996,0,34,7955,0,0,7955,41
1323,A,8000,7999,0,0,0,1,7999,1
1323,G,7997,0,0,7997,0,0,7997,0
1324,C,8000,0,7999,0,0,1,7999,1
1324,T,7984,0,1,0,0,7949,7949,35
1325,C,7953,0,7948,0,0,0,7948,5
1325,G,7992,1,0,7990,0,0,7990,2
1326,C,7958,1,7957,0,0,0,7957,1
1326,T,7989,0,0,0,0,7989,7989,0
1327,A,7969,7969,0,0,0,0,7969,0
1327,T,7951,0,0,0,0,7951,7951,0
1328,G,7961,0,0,7961,0,0,7961,0
1328,G,7999,0,0,7991,0,0,7991,8
1329,C,7960,0,7960,0,0,0,7960,0
1329,G,7999,1,0,7998,0,0,7998,1
1330,C,7999,0,7993,0,0,0,7993,6
1330,T,7993,0,1,0,0,7991,7991,2
1331,C,7992,0,7992,0,0,0,7992,0
1331,G,7993,0,0,7990,0,0,7990,3
1332,G,7962,0,0,7962,0,0,7962,0
1332,T,7983,0,3,0,0,7976,7976,7
1333,A,7957,7955,0,1,0,1,7955,2
1333,T,7983,0,0,0,0,7983,7983,0
1334,G,7978,0,0,7978,0,0,7978,0
1334,G,7988,0,0,7984,0,0,7984,4
1335,G,7996,0,0,7996,0,0,7996,0
1335,T,7970,0,1,0,0,7962,7962,8
1336,A,7996,7996,0,0,0,0,7996,0
1336,T,7970,35,0,0,0,7935,7935,35
1337,C,7964,0,7963,0,0,0,7963,1
1337,G,7989,1,1,7987,0,0,7987,2
1338,C,7989,0,7979,0,0,0,7979,10
1338,G,7963,2,0,7959,0,0,7959,4
1339,C,7956,0,7955,0,0,1,7955,1
1339,T,7963,0,0,0,0,7929,7929,34
1340,G,7965,35,0,7928,0,0,7928,37
1340,G,8000,2,0,7997,0,1,7997,3
1341,A,7963,7962,0,1,0,0,7962,1
1341,T,8000,0,0,0,0,8000,8000,0
1342,A,8001,8001,0,0,0,0,8001,0
1342,C,7966,0,7957,0,0,1,7957,9
1343,C,7960,3,7957,0,0,0,7957,3
1343,C,8002,1,8001,0,0,0,8001,1
1344,A,7999,7998,0,1,0,0,7998,1
1344,G,7960,1,0,7958,0,0,7958,2
1345,C,7983,0,7980,0,0,0,7980,3
1345,T,7999,0,0,0,0,7998,7998,1
1346,C,7981,0,7980,0,0,1,7980,1
1346,G,7997,1,0,7996,0,0,7996,1
1347,A,8000,7991,0,0,0,0,7991,9
1347,G,7988,1,0,7987,0,0,7987,1
1348,A,8001,8000,1,0,0,0,8000,1
1348,C,7992,0,7984,1,0,0,7984,8
1349,C,7993,0,7992,0,0,0,7992,1
1349,C,8000,1,7996,0,0,1,7996,4
1350,G,7993,0,1,7931,0,1,7931,62
1350,T,7933,1,0,0,0,7930,7930,3
1351,G,7948,1,0,7946,0,0,7946,2
1351,G,7999,0,34,7965,0,0,7965,34
1352,A,7941,7938,0,2,0,0,7938,3
1352,G,8000,1,34,7965,0,0,7965,35
1353,A,8000,7998,0,1,0,1,7998,2
1353,G,7960,0,0,7923,0,2,7923,37
1354,G,7967,0,0,7967,0,0,7967,0
1354,T,7992,0,0,0,0,7992,7992,0
1355,C,7989,0,7989,0,0,0,7989,0
1355,G,7990,0,0,7990,0,0,7990,0
1356,A,7998,7996,0,2,0,0,7996,2
1356,G,7995,0,0,7993,0,0,7993,2
1357,A,7990,7987,1,2,0,0,7987,3
1357,C,7999,0,7998,0,0,0,7998,1
1358,C,7995,0,7995,0,0,0,7995,0
1358,T,7996,0,34,0,0,7961,7961,35
1359,A,7993,7990,0,1,0,2,7990,3
1359,C,7997,0,7963,34,0,0,7963,34
1360,G,7996,0,0,7988,0,2,7988,8
1360,T,7980,0,0,34,0,7946,7946,34
1361,C,7998,0,7995,0,0,1,7995,3
1361,G,7995,0,0,7995,0,0,7995,0
1362,A,7991,7991,0,0,0,0,7991,0
1362,G,7998,1,0,7983,0,0,7983,15
1363,G,7997,0,0,7997,0,0,7997,0
1363,T,7986,0,0,2,0,7980,7980,6
1364,C,7998,0,7997,0,0,1,7997,1
1364,G,7987,1,0,7986,0,0,7986,1
1365,A,7993,7990,1,1,0,0,7990,3
1365,T,7995,0,1,0,0,7994,7994,1
1366,C,7999,0,7970,0,0,2,7970,29
1366,T,7980,1,2,1,0,7975,7975,5
1367,C,7997,1,7996,0,0,0,7996,1
1367,G,7986,0,0,7975,0,1,7975,11
1368,C,7997,0,7995,0,0,2,7995,2
1368,G,7999,1,0,7998,0,0,7998,1
1369,A,7973,7972,0,1,0,0,7972,1
1369,A,7998,7997,0,1,0,0,7997,1
1370,C,7988,0,7988,0,0,0,7988,0
1370,G,7980,0,0,7975,0,0,7975,5
1371,G,7988,1,1,7986,0,0,7986,2
1371,G,7999,0,0,7998,0,0,7998,1
1372,A,7993,7990,0,0,0,1,7990,3
1372,C,7988,0,7986,1,0,0,7986,2
1373,G,7969,0,0,7967,0,0,7967,2
1373,G,7998,0,0,7998,0,0,7998,0
1374,A,7958,7957,0,0,0,0,7957,1
1374,C,7999,0,7998,0,0,1,7998,1
1375,A,7953,7950,1,0,0,2,7950,3
1375,T,7994,0,2,0,0,7991,7991,3
1376,G,7999,1,0,7998,0,0,7998,1
1376,G,8000,0,0,7978,0,2,7978,22
1377,G,8001,1,0,7998,0,0,7998,3
1377,T,7995,1,2,0,0,7992,7992,3
1378,A,7996,7993,1,2,0,0,7993,3
1378,G,7999,4,1,7993,0,0,7993,6
1379,C,7995,1,7992,0,0,0,7992,3
1379,C,7999,1,7997,0,0,1,7997,2
1380,A,7988,7983,0,3,0,1,7983,5
1380,A,7991,7986,0,1,0,0,7986,5
1381,A,7990,7990,0,0,0,0,7990,0
1381,G,7997,1,0,7871,0,0,7871,126
1382,G,7996,0,0,7996,0,0,7996,0
1382,G,7999,0,0,7999,0,0,7999,0
1383,G,8000,0,0,7999,0,1,7999,1
1383,T,7983,0,0,0,0,7982,7982,1
1384,A,7983,7982,0,0,0,0,7982,1
1384,G,8001,0,0,8001,0,0,8001,0
1385,A,7942,7941,0,1,0,0,7941,1
1385,G,7981,4,2,7974,0,0,7974,7
1386,C,7976,0,7962,10,0,1,7962,14
1386,G,7940,1,0,7933,0,1,7933,7
1387,C,7975,0,7973,0,0,1,7973,2
1387,G,7954,0,0,7954,0,0,7954,0
1388,A,7954,7952,0,1,0,0,7952,2
1388,A,7985,7983,1,0,0,0,7983,2
1389,C,8000,0,7983,0,0,4,7983,17
1389,T,7942,1,0,0,0,7941,7941,1
1390,C,7965,0,7962,0,0,0,7962,3
1390,C,8000,1,7999,0,0,0,7999,1
1391,C,7958,1,7953,0,0,3,7953,5
1391,C,8000,1,7999,0,0,0,7999,1
1392,G,7958,0,1,7957,0,0,7957,1
1392,T,7992,1,0,0,0,7991,7991,1
1393,C,7959,0,7957,1,0,0,7957,2
1393,T,7989,0,1,0,0,7988,7988,1
1394,A,7955,7952,0,2,0,0,7952,3
1394,G,7991,0,0,7984,0,0,7984,7
1395,G,7981,1,0,7960,0,2,7960,21
1395,G,7992,0,0,7992,0,0,7992,0
1396,G,7985,0,0,7983,0,1,7983,2
1396,T,7992,0,1,0,0,7991,7991,1
1397,C,7987,0,7987,0,0,0,7987,0
1397,C,7992,0,7984,0,0,1,7984,8
1398,A,7952,7948,1,1,0,1,7948,4
1398,C,7992,0,7990,0,0,0,7990,2
1399,C,8000,1,7995,0,0,0,7995,5
1399,T,7980,0,0,0,0,7980,7980,0
1400,C,7997,0,7997,0,0,0,7997,0
1400,C,8001,0,8001,0,0,0,8001,0
1401,T,7996,0,1,0,0,7995,7995,1
1401,T,7999,1,1,0,0,7994,7994,5
1402,G,7998,0,0,7998,0,0,7998,0
1402,T,7995,0,0,0,0,7995,7995,0
1403,C,7999,0,15998,0,0,0,15998,-7999
1404,A,7995,7995,0,0,0,0,7995,0
1404,T,7993,0,0,0,0,7993,7993,0
1405,A,7998,7998,0,0,0,0,7998,0
1405,G,7999,1,0,7998,0,0,7998,1
1406,C,7999,0,7997,0,0,2,7997,2
1406,G,7994,0,1,7993,0,0,7993,1
1407,C,7998,0,7997,0,0,0,7997,1
1407,T,7996,0,1,0,0,7989,7989,7
1408,T,7970,0,2,0,0,7968,7968,2
1408,T,7997,1,1,0,0,7992,7992,5
1409,G,7971,0,0,7969,0,0,7969,2
1409,T,7964,2,0,0,0,7961,7961,3
1410,G,7973,1,0,15945,0,0,15945,-7972
1411,A,7972,7971,0,0,0,1,7971,1
1411,C,7977,0,7974,0,0,2,7974,3
1412,C,7972,0,7970,0,0,0,7970,2
1412,G,7975,0,0,7969,0,0,7969,6
1413,G,7998,1,0,7997,0,0,7997,1
1413,T,7969,0,0,0,0,7969,7969,0
1414,G,7986,0,0,7986,0,0,7986,0
1414,T,7996,0,0,1,0,7994,7994,2
1415,A,7984,7984,0,0,0,0,7984,0
1415,C,7997,0,7995,0,0,1,7995,2
1416,C,7999,0,7998,0,0,1,7998,1
1416,T,7998,0,0,0,0,7998,7998,0
1417,G,7999,1,0,7995,0,0,7995,4
1417,T,7997,0,0,0,0,7996,7996,1
1418,G,7998,0,0,7998,0,0,7998,0
1418,G,7999,1,0,7998,0,0,7998,1
1419,A,7995,7993,0,0,0,0,7993,2
1419,G,8001,0,0,8001,0,0,8001,0
1420,G,7998,1,0,7995,0,0,7995,3
1420,T,7998,0,0,0,0,7996,7996,2
1421,A,7997,7997,0,0,0,0,7997,0
1421,G,7997,2,0,7995,0,0,7995,2
1422,C,7989,0,7983,0,0,2,7983,6
1422,T,7998,0,1,2,0,7995,7995,3
1423,A,7976,7974,0,0,0,0,7974,2
1423,C,8000,0,8000,0,0,0,8000,0
1424,C,7996,0,7995,0,0,1,7995,1
1424,C,7997,0,7997,0,0,0,7997,0
1425,A,7970,7970,0,0,0,0,7970,0
1425,T,7999,0,1,0,0,7998,7998,1
1426,C,7999,0,7998,0,0,0,7998,1
1426,G,7998,0,0,7997,0,1,7997,1
1427,C,7970,0,7969,1,0,0,7969,1
1427,G,8000,2,0,7997,0,0,7997,3
1428,G,7969,1,0,7966,0,1,7966,3
1428,T,7999,0,0,0,0,7999,7999,0
1429,A,8000,8000,0,0,0,0,8000,0
1429,T,7963,0,0,0,0,7963,7963,0
1430,A,7964,7964,0,0,0,0,7964,0
1430,G,7998,0,0,7931,0,0,7931,67
1431,C,7986,0,7978,0,0,0,7978,8
1431,G,7989,0,0,7989,0,0,7989,0
1432,C,7986,0,7986,0,0,0,7986,0
1432,G,7974,1,1,7972,0,0,7972,2
1433,G,7959,1,1,7957,0,0,7957,2
1433,T,7969,0,0,0,0,7966,7966,3
1434,C,7946,1,7944,0,0,1,7944,2
1434,T,7973,0,0,0,0,7973,7973,0
1435,C,7969,0,7969,0,0,0,7969,0
1435,G,7925,0,0,7922,0,1,7922,3
1436,A,7958,7958,0,0,0,0,7958,0
1436,G,8000,1,1,7995,0,0,7995,5
1437,C,7997,0,7969,0,0,0,7969,28
1437,G,7999,0,0,7997,0,0,7997,2
1438,C,7997,0,7996,0,0,1,7996,1
1438,C,7999,0,7999,0,0,0,7999,0
1439,C,7997,0,7997,0,0,0,7997,0
1439,T,7994,2,0,0,0,7992,7992,2
1440,C,7992,0,7992,0,0,0,7992,0
1440,T,7996,0,0,0,0,7994,7994,2
1441,A,7993,7992,0,0,0,0,7992,1
1441,C,7997,0,7994,1,0,0,7994,3
1442,C,7998,0,7998,0,0,0,7998,0
1442,G,8001,2,0,7999,0,0,7999,2
1443,A,7997,7997,0,0,0,0,7997,0
1443,C,8003,0,7969,0,0,1,7969,34
1444,C,8001,0,7999,0,0,1,7999,2
1444,G,7998,0,0,7997,0,1,7997,1
1445,A,7998,7996,1,0,0,0,7996,2
1445,C,7974,0,7974,0,0,0,7974,0
1446,C,7989,0,7989,0,0,0,7989,0
1446,T,7973,0,0,0,0,7972,7972,1
1447,A,7988,7986,0,0,0,1,7986,2
1447,C,7978,0,7973,0,0,2,7973,5
1448,G,7981,1,0,7978,0,1,7978,3
1448,T,7993,1,1,0,0,7991,7991,2
1449,C,7991,1,7942,0,0,0,7942,49
1449,G,7998,0,0,7998,0,0,7998,0
1450,A,7999,7997,0,1,0,0,7997,2
1450,C,7991,0,7991,0,0,0,7991,0
1451,C,7990,0,7990,0,0,0,7990,0
1451,T,7998,1,0,0,0,7997,7997,1
1452,A,7999,7990,0,0,0,1,7990,9
1452,T,7988,2,2,1,0,7982,7982,6
1453,A,7981,7978,0,2,0,1,7978,3
1453,C,7989,0,7986,1,0,2,7986,3
1454,G,7990,1,0,7989,0,0,7989,1
1454,G,7998,0,0,7997,0,0,7997,1
1455,A,7988,7986,0,2,0,0,7986,2
1455,A,8000,7999,0,0,0,0,7999,1
1456,T,7986,1,0,0,0,7984,7984,2
1456,T,7997,0,0,0,0,7997,7997,0
1457,A,7956,7953,0,0,0,1,7953,3
1457,C,7999,0,7998,0,0,0,7998,1
1458,C,7966,0,7964,0,0,2,7964,2
1458,T,7994,0,1,0,0,7993,7993,1
1459,A,7967,7967,0,0,0,0,7967,0
1459,C,7994,0,7994,0,0,0,7994,0
1460,G,7992,2,0,7990,0,0,7990,2
1460,T,7969,0,0,0,0,7962,7962,7
1461,A,7994,7992,0,0,0,0,7992,2
1461,T,7959,0,0,0,0,7959,7959,0
1462,A,8000,7999,1,0,0,0,7999,1
1462,G,7971,0,0,7970,0,0,7970,1
1463,A,7963,7961,0,2,0,0,7961,2
1463,C,8000,0,7998,0,0,1,7998,2
1464,T,7958,0,1,1,0,7955,7955,3
1464,T,7991,0,0,0,0,7991,7991,0
1465,C,7990,0,7990,0,0,0,7990,0
1465,G,7971,0,0,7971,0,0,7971,0
1466,A,7968,7967,0,0,0,0,7967,1
1466,G,7988,3,0,7983,0,1,7983,5
1467,G,7969,0,0,7968,0,1,7968,1
1467,T,7989,0,1,0,0,7988,7988,1
1468,G,7989,1,0,7976,0,0,7976,13
1468,T,7961,0,0,1,0,7950,7950,11
1469,G,7999,0,0,7999,0,0,7999,0
1469,T,7962,0,0,0,0,7962,7962,0
1470,C,8000,0,7998,0,0,0,7998,2
1470,T,7962,0,1,1,0,7960,7960,2
1471,C,8000,0,7999,0,0,1,7999,1
1471,G,7977,0,0,7962,0,0,7962,15
1472,G,7980,1,0,7979,0,0,7979,1
1472,G,7995,2,0,7993,0,0,7993,2
1473,A,7980,7978,0,2,0,0,7978,2
1473,T,8000,0,0,0,0,7998,7998,2
1474,C,7979,1,7976,0,0,1,7976,3
1474,T,8001,0,1,0,0,8000,8000,1
1475,A,7952,7949,0,0,0,0,7949,3
1475,C,8001,0,8001,0,0,0,8001,0
1476,A,7964,7964,0,0,0,0,7964,0
1476,A,8001,8001,0,0,0,0,8001,0
1477,A,7975,7975,0,0,0,0,7975,0
1477,C,8002,0,8002,0,0,0,8002,0
1478,C,7986,1,7963,0,0,0,7963,23
1478,G,7998,0,0,7993,0,0,7993,5
1479,C,7986,1,7985,0,0,0,7985,1
1479,G,8000,0,0,7999,0,0,7999,1
1480,A,7986,7986,0,0,0,0,7986,0
1480,A,7989,7988,0,1,0,0,7988,1
1481,C,7999,0,7998,0,0,0,7998,1
1481,G,7998,1,0,7996,0,1,7996,2
1482,A,8000,7996,0,0,0,0,7996,4
1482,C,7996,0,7973,0,0,0,7973,23
1483,A,8001,7997,0,3,0,1,7997,4
1483,C,7997,0,7997,0,0,0,7997,0
1484,C,7998,0,7998,0,0,0,7998,0
1484,C,8002,0,8000,0,0,0,8000,2
1485,T,7993,0,0,0,0,7992,7992,1
1485,T,7998,0,1,0,0,7997,7997,1
1486,A,7994,7994,0,0,0,0,7994,0
1486,C,8000,0,7995,0,0,0,7995,5
1487,C,7998,0,7998,0,0,0,7998,0
1487,G,7991,1,0,7990,0,0,7990,1
1488,A,7986,7983,0,0,0,0,7983,3
1488,A,7996,7995,0,1,0,0,7995,1
1489,A,7987,7986,1,0,0,0,7986,1
1489,T,7994,0,0,0,0,7993,7993,1
1490,G,7998,1,0,7996,0,0,7996,2
1490,T,7968,0,0,1,0,7967,7967,1
1491,G,7969,0,0,7968,0,0,7968,1
1491,T,7983,0,2,0,0,7980,7980,3
1492,C,7971,0,7971,0,0,0,7971,0
1492,G,7977,0,0,7977,0,0,7977,0
1493,A,7942,7942,0,0,0,0,7942,0
1493,C,7964,1,7962,1,0,0,7962,2
1494,A,7975,7972,1,1,0,0,7972,3
1494,G,7950,0,0,7949,0,0,7949,1
1495,C,7999,0,7997,0,0,1,7997,2
1495,T,7945,0,0,0,0,7944,7944,1
1496,C,7978,0,7978,0,0,0,7978,0
1496,G,7950,0,0,7949,0,0,7949,1
1497,A,7950,7767,0,0,0,0,7767,183
1497,T,7980,1,0,0,0,7973,7973,7
1498,A,7952,7951,0,1,0,0,7951,1
1498,T,7978,0,1,0,0,7977,7977,1
1499,A,7954,7953,0,1,0,0,7953,1
1499,G,7977,0,0,7977,0,0,7977,0
1500,A,7955,7955,0,0,0,0,7955,0
1500,A,7977,7973,0,0,0,0,7973,4
1501,A,7956,7956,0,0,0,0,7956,0
1501,A,7976,7976,0,0,0,0,7976,0
1502,A,7956,7956,0,0,0,0,7956,0
1502,G,7981,0,0,7980,0,1,7980,1
1503,A,7956,7955,0,1,0,0,7955,1
1503,C,7992,0,7989,0,0,1,7989,3
1504,G,7965,1,1,7963,0,0,7963,2
1504,T,7955,2,0,0,0,7952,7952,3
1505,C,7988,0,7987,0,0,0,7987,1
1505,G,7956,0,0,7956,0,0,7956,0
1506,A,7988,7987,0,0,0,0,7987,1
1506,C,7958,0,7957,0,0,1,7957,1
1507,T,7958,0,1,0,0,7949,7949,9
1507,T,7989,0,0,0,0,7989,7989,0
1508,G,7992,0,0,7991,0,0,7991,1
1508,T,7959,1,0,0,0,7958,7958,1
1509,A,7993,7992,0,0,0,0,7992,1
1509,T,7959,1,0,0,0,7958,7958,1
1510,A,7961,7959,1,0,0,0,7959,2
1510,A,7996,7995,0,1,0,0,7995,1
1511,C,7999,1,7996,0,0,1,7996,3
1511,T,7964,0,0,0,0,7945,7945,19
1512,T,7963,1,1,0,0,7961,7961,2
1512,T,7987,0,0,0,0,7986,7986,1
1513,C,8000,0,7997,0,0,0,7997,3
1513,T,7963,0,0,0,0,7963,7963,0
1514,C,7992,1,7991,0,0,0,7991,1
1514,G,7969,1,0,7967,0,1,7967,2
1515,T,7969,0,0,0,0,7968,7968,1
1515,T,7992,0,1,0,0,7988,7988,4
1516,G,7970,0,0,7970,0,0,7970,0
1516,T,7992,0,0,1,0,7988,7988,4
1517,A,7970,7958,0,1,0,0,7958,12
1517,G,7996,1,0,7995,0,0,7995,1
1518,A,7972,7971,0,1,0,0,7971,1
1518,A,7997,7997,0,0,0,0,7997,0
1519,A,7972,7970,0,0,0,1,7970,2
1519,T,7999,2,0,1,0,7996,7996,3
1520,G,7993,1,0,7992,0,0,7992,1
1520,T,7973,0,1,0,0,7963,7963,10
1521,A,7992,7989,1,1,0,0,7989,3
1521,T,7981,0,0,0,0,7981,7981,0
1522,T,7959,0,1,0,0,7957,7957,2
1522,T,7982,0,0,0,0,7982,7982,0
1523,G,7964,0,0,7959,0,1,7959,5
1523,G,7984,2,0,7981,0,0,7981,3
1524,G,7981,0,0,7981,0,0,7981,0
1524,T,7985,0,0,0,0,7984,7984,1
1525,C,7981,1,7977,0,0,2,7977,4
1525,G,7985,0,0,7983,0,1,7983,2
1526,A,7988,7988,0,0,0,0,7988,0
1526,C,7977,0,7977,0,0,0,7977,0
1527,A,7998,7995,1,0,0,1,7995,3
1527,T,7995,0,0,0,0,7995,7995,0
1528,G,7997,0,0,7997,0,0,7997,0
1528,T,8000,0,1,0,0,7999,7999,1
1529,C,7998,1,7996,0,0,1,7996,2
1529,G,8001,1,0,7999,0,0,7999,2
1530,T,7992,0,0,0,0,7990,7990,2
1530,T,8000,0,0,1,0,7995,7995,5
1531,A,7999,7998,0,1,0,0,7998,1
1531,T,7994,0,0,0,0,7994,7994,0
1532,A,7996,7996,0,0,0,0,7996,0
1532,T,7999,0,0,0,0,7995,7995,4
1533,T,7990,0,0,1,0,7989,7989,1
1533,T,8000,0,0,0,0,8000,8000,0
1534,C,7993,0,7992,0,0,0,7992,1
1534,G,8001,0,0,8000,0,1,8000,1
1535,C,7998,0,7995,0,0,2,7995,3
1535,C,7999,0,7999,0,0,0,7999,0
1536,T,7966,0,0,0,0,7964,7964,2
1536,T,7993,0,3,0,0,7982,7982,11
1537,C,7970,0,7969,1,0,0,7969,1
1537,T,7990,0,0,0,0,7990,7990,0
1538,C,7938,1,7937,0,0,0,7937,1
1538,T,7984,1,0,0,0,7983,7983,1
1539,A,7999,7996,0,1,0,1,7996,3
1539,T,7935,0,0,0,0,7935,7935,0
1540,C,7943,0,7943,0,0,0,7943,0
1540,T,7999,0,0,0,0,7990,7990,9
1541,G,7943,1,0,7940,0,1,7940,3
1541,T,8000,0,0,0,0,8000,8000,0
1542,C,7993,0,7954,0,0,1,7954,39
1542,T,7997,0,2,0,0,7995,7995,2
1543,C,7993,0,7993,0,0,0,7993,0
1543,G,7992,1,0,7991,0,0,7991,1
1544,C,7991,1,7988,0,0,0,7988,3
1544,T,7977,0,1,0,0,7975,7975,2
1545,A,7979,7979,0,0,0,0,7979,0
1545,T,7990,0,3,1,0,7981,7981,9
1546,A,7981,7981,0,0,0,0,7981,0
1546,T,7991,0,0,0,0,7991,7991,0
1547,C,7999,0,7996,0,0,0,7996,3
1547,G,8000,3,0,7997,0,0,7997,3
1548,C,7987,0,7987,0,0,0,7987,0
1548,C,8000,0,7999,0,0,0,7999,1
1549,A,7995,7995,0,0,0,0,7995,0
1549,T,7995,0,1,0,0,7992,7992,3
1550,C,8000,1,7999,0,0,0,7999,1
1550,T,7999,0,0,0,0,7997,7997,2
1551,A,7973,7971,0,1,0,1,7971,2
1551,T,7999,0,0,0,0,7998,7998,1
1552,A,7998,7998,0,0,0,0,7998,0
1552,C,8000,0,7994,0,0,0,7994,6
1553,C,7995,0,7995,0,0,0,7995,0
1553,T,7996,0,0,0,0,7994,7994,2
1554,A,7998,7995,0,0,0,0,7995,3
1554,A,8000,7999,0,0,0,0,7999,1
1555,A,7997,7996,0,0,0,1,7996,1
1555,T,7998,0,1,0,0,7996,7996,2
1556,G,7968,0,0,7968,0,0,7968,0
1556,G,7992,0,0,7986,0,0,7986,6
1557,C,7971,0,7971,0,0,0,7971,0
1557,G,7998,0,0,7997,0,0,7997,1
1558,A,7999,7999,0,0,0,0,7999,0
1558,T,7913,0,0,0,0,7912,7912,1
1559,G,7958,5,0,7953,0,0,7953,5
1559,T,7986,1,0,0,0,7985,7985,1
1560,C,7960,0,7959,0,0,1,7959,1
1560,C,7986,0,7980,1,0,0,7980,6
1561,A,7960,7958,0,0,0,0,7958,2
1561,C,7941,2,7937,1,0,0,7937,4
1562,A,7973,7972,1,0,0,0,7972,1
1562,G,7944,0,0,7942,0,0,7942,2
1563,A,7943,7941,0,0,0,1,7941,2
1563,T,7972,0,0,0,0,7972,7972,0
1564,A,7980,7965,0,2,0,3,7965,15
1564,G,7961,0,0,7961,0,0,7961,0
1565,A,7979,7979,0,0,0,0,7979,0
1565,C,7961,0,7961,0,0,0,7961,0
1566,A,7978,7977,1,0,0,0,7977,1
1566,T,7947,0,0,0,0,7945,7945,2
1567,C,7949,0,7946,0,0,0,7946,3
1567,C,7985,0,7983,0,0,2,7983,2
1568,A,7960,7954,0,0,0,1,7954,6
1568,G,7944,2,0,7939,0,0,7939,5
1569,A,7966,7965,1,0,0,0,7965,1
1569,G,7999,1,0,7998,0,0,7998,1
1570,G,7983,0,0,7982,0,1,7982,1
1570,T,8000,0,0,0,0,7999,7999,1
1571,A,8000,7999,0,0,0,0,7999,1
1571,T,7980,0,1,1,0,7976,7976,4
1572,C,7999,0,7996,0,0,0,7996,3
1572,T,7981,0,0,0,0,7981,7981,0
1573,A,7987,7986,0,0,0,0,7986,1
1573,C,7997,0,7997,0,0,0,7997,0
1574,A,7987,7986,0,0,0,0,7986,1
1574,A,7999,7988,1,1,0,0,7988,11
1575,A,7999,7999,0,0,0,0,7999,0
1575,C,7997,1,7996,0,0,0,7996,1
1576,A,7996,7991,0,0,0,0,7991,5
1576,G,7999,1,0,7998,0,0,7998,1
1577,A,7999,7998,0,0,0,0,7998,1
1577,C,8000,0,7999,0,0,0,7999,1
1578,C,7995,0,7993,0,0,0,7993,2
1578,T,7976,1,1,0,0,7971,7971,5
1579,A,7985,7977,0,0,0,1,7977,8
1579,T,7977,0,1,0,0,7975,7975,2
1580,A,7976,7973,1,0,0,0,7973,3
1580,A,7987,7986,0,0,0,1,7986,1
1581,A,7983,7979,0,3,0,1,7979,4
1581,C,7998,0,7996,0,0,1,7996,2
1582,A,7997,7990,0,0,0,0,7990,7
1582,G,7999,0,0,7997,0,1,7997,2
1583,A,7999,7997,0,0,0,2,7997,2
1583,T,7997,0,0,0,0,7978,7978,19
1584,T,7994,0,1,0,0,7993,7993,1
1584,T,7996,0,0,1,0,7991,7991,5
1585,T,7979,1,0,0,0,7977,7977,2
1585,T,7996,1,0,0,0,7995,7995,1
1586,A,7979,7963,0,0,0,1,7963,16
1586,G,7997,0,0,7997,0,0,7997,0
1587,A,7981,7980,0,1,0,0,7980,1
1587,C,7984,0,7982,0,0,2,7982,2
1588,A,7983,7983,0,0,0,0,7983,0
1588,A,7999,7999,0,0,0,0,7999,0
1589,C,7999,2,7994,0,0,2,7994,5
1589,T,7982,1,0,0,0,7975,7975,7
1590,G,7993,0,0,7992,0,0,7992,1
1590,T,7978,0,0,0,0,7978,7978,0
1591,C,7991,0,7991,0,0,0,7991,0
1591,C,7998,0,7998,0,0,0,7998,0
1592,A,7999,7999,0,0,0,0,7999,0
1592,T,7987,1,0,0,0,7986,7986,1
1593,A,7998,7997,0,1,0,0,7997,1
1593,T,8000,1,0,0,0,7965,7965,35
1594,G,7998,1,0,7996,0,0,7996,2
1594,T,8000,0,0,0,0,8000,8000,0
1595,C,8000,0,7995,0,0,0,7995,5
1595,T,7998,0,0,0,0,7998,7998,0
1596,C,8000,0,7998,0,0,1,7998,2
1596,T,7997,0,2,0,0,7995,7995,2
1597,A,7993,7990,0,1,0,0,7990,3
1597,A,7997,7995,0,0,0,0,7995,2
1598,G,7999,3,0,7993,0,2,7993,6
1598,T,7996,0,0,0,0,7996,7996,0
1599,C,7999,1,7993,1,0,1,7993,6
1599,G,7998,1,0,7997,0,0,7997,1
1600,T,7968,0,0,0,0,7944,7944,24
1600,T,7999,0,1,1,0,7994,7994,5
1601,T,7973,0,0,0,0,7973,7973,0
1601,T,7997,0,3,1,0,7993,7993,4
1602,G,7997,0,0,7967,0,2,7967,30
1602,T,7970,0,0,0,0,7969,7969,1
1603,C,7970,1,7967,0,0,2,7967,3
1603,G,7999,0,0,7997,0,2,7997,2
1604,A,7971,7969,0,1,0,0,7969,2
1604,G,8001,0,0,8001,0,0,8001,0
1605,G,7995,0,0,7983,0,2,7983,12
1605,T,7998,0,0,0,0,7996,7996,2
1606,C,7997,0,7996,1,0,0,7996,1
1606,G,7998,2,0,7995,0,0,7995,3
1607,T,7994,1,0,0,0,7992,7992,2
1607,T,7996,0,0,2,0,7988,7988,8
1608,C,8000,0,7949,0,0,0,7949,51
1608,T,7996,0,0,0,0,7996,7996,0
1609,C,7997,0,7996,0,0,1,7996,1
1609,C,8000,0,7999,0,0,1,7999,1
1610,A,7996,7993,1,0,0,1,7993,3
1610,C,7999,0,7998,1,0,0,7998,1
1611,G,7998,1,0,7847,0,0,7847,151
1611,T,7998,0,0,1,0,7995,7995,3
1612,A,7994,7991,1,1,0,1,7991,3
1612,G,7998,0,0,7998,0,0,7998,0
1613,G,7999,0,0,7999,0,0,7999,0
1613,T,7997,1,0,1,0,7995,7995,2
1614,A,7996,7993,0,0,0,1,7993,3
1614,G,7989,0,0,7989,0,0,7989,0
1615,G,7984,3,0,7980,0,1,7980,4
1615,G,7994,0,0,7993,0,0,7993,1
1616,A,7988,7975,0,11,0,0,7975,13
1616,T,7803,0,1,0,0,7802,7802,1
1617,G,7737,0,1,7734,0,0,7734,3
1617,G,7998,0,0,7986,0,0,7986,12
1618,A,7683,7680,0,1,0,1,7680,3
1618,G,7998,2,0,7994,0,0,7994,4
1619,G,7708,1,0,7704,0,1,7704,4
1619,T,7995,0,0,1,0,7993,7993,2
1620,G,7999,2,0,7994,0,0,7994,5
1620,T,7706,0,0,0,0,7704,7704,2
1621,C,7686,3,7681,1,0,1,7681,5
1621,T,7989,0,0,1,0,7988,7988,1
1622,G,7712,0,0,7710,0,1,7710,2
1622,G,7991,0,0,7947,0,1,7947,44
1623,G,7990,0,0,7990,0,0,7990,0
1623,T,7740,0,0,0,0,7739,7739,1
1624,A,7740,7740,0,0,0,0,7740,0
1624,G,7988,0,0,7987,0,0,7987,1
1625,A,7981,7976,0,0,0,1,7976,5
1625,T,7740,2,0,1,0,7730,7730,10
1626,G,7977,1,0,7967,0,2,7967,10
1626,T,7740,0,0,1,0,7739,7739,1
1627,A,7747,7737,0,1,0,1,7737,10
1627,G,7980,0,0,7976,0,2,7976,4
1628,A,7734,7732,0,1,0,0,7732,2
1628,T,7972,0,0,7,0,7698,7698,274
1629,T,7733,0,0,0,0,7729,7729,4
1629,T,7979,0,1,0,0,7978,7978,1
1630,T,7734,0,0,0,0,7734,7734,0
1630,T,7983,0,0,0,0,7983,7983,0
1631,T,7731,0,0,0,0,7731,7731,0
1631,T,7983,0,0,0,0,7983,7983,0
1632,C,7735,0,7734,0,0,0,7734,1
1632,T,7983,0,1,0,0,7982,7982,1
1633,G,7734,0,0,7734,0,0,7734,0
1633,T,7982,6,0,0,0,7976,7976,6
1634,A,7734,7734,0,0,0,0,7734,0
1634,A,7983,7964,0,0,0,2,7964,19
1635,A,7983,7982,0,0,0,1,7982,1
1635,T,7736,0,1,0,0,7734,7734,2
1636,A,7734,7733,0,0,0,0,7733,1
1636,A,7977,7977,0,0,0,0,7977,0
1637,A,7749,7749,0,0,0,0,7749,0
1637,G,7979,0,0,7979,0,0,7979,0
1638,C,7980,0,7979,0,0,1,7979,1
1638,G,7769,2,0,7765,0,1,7765,4
1639,A,7982,7980,0,1,0,0,7980,2
1639,C,7854,0,7830,0,0,2,7830,24
1640,A,7998,7998,0,0,0,0,7998,0
1640,C,7853,0,7853,0,0,0,7853,0
1641,A,7869,7868,0,0,0,1,7868,1
1641,G,7998,0,0,7998,0,0,7998,0
1642,G,7878,2,0,7876,0,0,7876,2
1642,T,7999,0,0,0,0,7999,7999,0
1643,A,7999,7967,0,0,0,1,7967,32
1643,T,7879,0,0,0,0,7879,7879,0
1644,A,7888,7879,0,2,0,1,7879,9
1644,A,7999,7999,0,0,0,0,7999,0
1645,A,7893,7892,0,0,0,1,7892,1
1645,A,7999,7998,0,0,0,0,7998,1
1646,A,7997,7996,0,1,0,0,7996,1
1646,G,7921,0,0,7918,0,3,7918,3
1647,C,7921,0,7920,0,0,1,7920,1
1647,C,7997,0,7988,0,0,0,7988,9
1648,A,7892,7890,0,0,0,1,7890,2
1648,C,7990,0,7990,0,0,0,7990,0
1649,G,7897,0,0,7895,0,0,7895,2
1649,T,7974,0,1,0,0,7971,7971,3
1650,C,7998,1,7997,0,0,0,7997,1
1650,T,7888,1,0,0,0,7887,7887,1
1651,G,7899,0,1,7881,0,0,7881,18
1651,T,7999,0,0,0,0,7998,7998,1
1652,A,8000,7998,0,1,0,0,7998,2
1652,G,7899,0,0,7898,0,1,7898,1
1653,C,8001,1,8000,0,0,0,8000,1
1653,G,7988,0,0,7988,0,0,7988,0
1654,A,7995,7983,1,1,0,0,7983,12
1654,T,7989,0,1,0,0,7983,7983,6
1655,A,7999,7998,0,0,0,1,7998,1
1655,T,7989,0,0,0,0,7988,7988,1
1656,A,7992,7992,0,0,0,0,7992,0
1656,C,7999,0,7995,0,0,1,7995,4
1657,T,7992,0,0,1,0,7991,7991,1
1657,T,7999,2,2,0,0,7993,7993,6
1658,C,7999,0,7997,0,0,2,7997,2
1658,G,7997,0,0,7995,0,0,7995,2
1659,T,7974,0,0,1,0,7973,7973,1
1659,T,7999,0,0,0,0,7999,7999,0
1660,A,7996,7996,0,0,0,0,7996,0
1660,G,7979,0,0,7969,0,2,7969,10
1661,G,7997,0,0,7997,0,0,7997,0
1661,G,8000,0,0,7999,0,0,7999,1
1662,T,7960,0,0,0,0,7959,7959,1
1662,T,7997,0,0,0,0,7996,7996,1
1663,A,7997,7996,0,1,0,0,7996,1
1663,T,7969,0,0,0,0,7969,7969,0
1664,A,7977,7976,0,1,0,0,7976,1
1664,T,7994,0,0,0,0,7992,7992,2
1665,G,7986,1,0,7985,0,0,7985,1
1665,T,7987,0,0,0,0,7987,7987,0
1666,C,8000,0,7990,0,0,3,7990,10
1666,G,7998,0,0,7988,0,1,7988,10
1667,C,7997,0,7997,0,0,0,7997,0
1667,G,7997,0,0,7997,0,0,7997,0
1668,A,7996,7992,0,1,0,0,7992,4
1668,C,7996,1,7970,0,0,1,7970,26
1669,C,7992,1,7990,0,0,1,7990,2
1669,G,7994,2,0,7991,0,0,7991,3
1670,A,7994,7992,0,1,0,1,7992,2
1670,C,7942,0,7941,0,0,1,7941,1
1671,A,7966,7966,0,0,0,0,7966,0
1671,G,7998,0,0,7997,0,0,7997,1
1672,A,7994,7991,0,2,0,0,7991,3
1672,T,7999,0,0,0,0,7999,7999,0
1673,C,8000,0,8000,0,0,0,8000,0
1673,G,7996,0,0,7996,0,0,7996,0
1674,C,7996,0,7994,0,0,1,7994,2
1674,T,8001,1,0,0,0,7999,7999,2
1675,C,7998,0,7996,0,0,1,7996,2
1675,T,7984,0,2,0,0,7982,7982,2
1676,C,8000,0,7998,0,0,0,7998,2
1676,T,7990,0,1,0,0,7988,7988,2
1677,A,7993,7992,1,0,0,0,7992,1
1677,T,7998,0,0,0,0,7997,7997,1
1678,G,7999,0,0,7999,0,0,7999,0
1678,T,7993,0,0,0,0,7991,7991,2
1679,C,7990,0,7989,0,0,1,7989,1
1679,C,7999,0,7998,0,0,0,7998,1
1680,G,7982,1,0,7972,0,0,7972,10
1680,T,7998,2,1,0,0,7991,7991,7
1681,G,7973,0,0,7973,0,0,7973,0
1681,T,7999,0,1,0,0,7996,7996,3
1682,A,7988,7987,0,1,0,0,7987,1
1682,T,7947,0,0,0,0,7946,7946,1
1683,A,7975,7975,0,0,0,0,7975,0
1683,T,7988,0,0,0,0,7988,7988,0
1684,A,7991,7988,0,1,0,0,7988,3
1684,T,7993,0,1,0,0,7992,7992,1
1685,C,7992,0,7991,0,0,1,7991,1
1685,T,7979,0,1,0,0,7978,7978,1
1686,A,7901,7898,0,1,0,0,7898,3
1686,G,7992,2,0,7990,0,0,7990,2
1687,G,7919,0,0,7916,0,1,7916,3
1687,T,7999,0,1,0,0,7998,7998,1
1688,A,7912,7911,0,0,0,1,7911,1
1688,A,7997,7995,0,1,0,0,7995,2
1689,C,7937,0,7933,0,0,1,7933,4
1689,G,7999,0,0,7999,0,0,7999,0
1690,C,7892,0,7892,0,0,0,7892,0
1690,C,7977,0,7976,0,0,1,7976,1
1691,A,7975,7974,0,0,0,1,7974,1
1691,T,7884,0,1,0,0,7882,7882,2
1692,C,7903,1,7878,0,0,1,7878,25
1692,T,7968,0,0,0,0,7967,7967,1
1693,A,7957,7952,0,1,0,0,7952,5
1693,C,7921,0,7920,0,0,0,7920,1
1694,A,7977,7975,1,0,0,0,7975,2
1694,C,7921,0,7920,0,0,1,7920,1
1695,A,7933,7933,0,0,0,0,7933,0
1695,C,7998,0,7943,0,0,1,7943,55
1696,C,7973,0,7966,0,0,0,7966,7
1696,C,7991,0,7991,0,0,0,7991,0
1697,C,7961,1,7959,0,0,1,7959,2
1697,C,7996,0,7996,0,0,0,7996,0
1698,C,7969,1,7967,0,0,1,7967,2
1698,G,7999,1,0,7998,0,0,7998,1
1699,T,7969,1,2,0,0,7965,7965,4
1699,T,7997,0,0,0,0,7997,7997,0
1700,A,7995,7995,0,0,0,0,7995,0
1700,T,7970,0,0,1,0,7969,7969,1
1701,C,7996,0,7992,0,0,3,7992,4
1701,G,7969,0,0,7897,0,0,7897,72
1702,A,7994,7992,1,0,0,0,7992,2
1702,G,7968,0,0,7967,0,1,7967,1
1703,C,8000,1,7997,0,0,1,7997,3
1703,G,7962,0,0,7962,0,0,7962,0
1704,G,7946,2,1,7943,0,0,7943,3
1704,G,7995,1,0,7994,0,0,7994,1
1705,C,7981,0,7975,0,0,0,7975,6
1705,C,7992,0,7989,0,0,0,7989,3
1706,C,7987,0,7987,0,0,0,7987,0
1706,C,7989,0,7988,0,0,1,7988,1
1707,T,7970,1,1,1,0,7967,7967,3
1707,T,7985,1,1,0,0,7983,7983,2
1708,A,7968,7967,1,0,0,0,7967,1
1708,C,7999,0,7999,0,0,0,7999,0
1709,C,7984,0,7977,0,0,0,7977,7
1709,T,7999,0,0,0,0,7999,7999,0
1710,A,8000,7976,0,0,0,0,7976,24
1710,C,7981,0,7980,0,0,1,7980,1
1711,A,8000,7999,0,1,0,0,7999,1
1711,G,7997,1,0,7996,0,0,7996,1
1712,A,7998,7995,3,0,0,0,7995,3
1712,C,7991,0,7976,0,0,0,7976,15
1713,C,7991,0,7991,0,0,0,7991,0
1713,C,7997,1,7987,3,0,0,7987,10
1714,C,7990,0,7990,0,0,0,7990,0
1714,G,7951,1,0,7928,0,0,7928,23
1715,A,7991,7989,0,0,0,1,7989,2
1715,G,7975,0,0,7975,0,0,7975,0
1716,G,7993,1,0,7992,0,0,7992,1
1716,T,7993,0,0,0,0,7983,7983,10
1717,T,7986,0,0,0,0,7986,7986,0
1717,T,7994,0,1,0,0,7993,7993,1
1718,C,7999,0,7999,0,0,0,7999,0
1718,T,7996,0,0,0,0,7996,7996,0
1719,G,8000,0,0,8000,0,0,8000,0
1719,T,7998,0,0,0,0,7990,7990,8
1720,C,7988,0,7986,0,0,1,7986,2
1720,T,7998,0,0,0,0,7998,7998,0
1721,G,7988,0,0,7987,0,0,7987,1
1721,G,7998,0,0,7997,0,0,7997,1
1722,A,7997,7995,0,1,0,0,7995,2
1722,T,7986,0,0,0,0,7986,7986,0
1723,C,7992,0,7991,0,0,1,7991,1
1723,G,7999,1,0,7866,0,0,7866,133
1724,A,7989,7978,0,2,0,0,7978,11
1724,G,7982,0,0,7981,0,1,7981,1
1725,A,7993,7992,0,1,0,0,7992,1
1725,G,7979,0,0,7979,0,0,7979,0
1726,G,7980,0,0,7951,0,8,7951,29
1726,T,7993,1,0,0,0,7990,7990,3
1727,G,7996,1,0,7918,0,0,7918,78
1727,T,7956,0,0,2,0,7695,7695,261
1728,G,7996,2,0,7993,0,1,7993,3
1728,T,7988,0,0,1,0,7987,7987,1
1729,G,7994,1,0,7993,0,0,7993,1
1729,T,7994,0,1,0,0,7993,7993,1
1730,G,8000,0,2,7996,0,1,7996,4
1730,T,7998,0,0,0,0,7998,7998,0
1731,C,7999,1,7996,1,0,1,7996,3
1731,T,7999,0,0,0,0,7999,7999,0
1732,G,8000,1,0,7989,0,2,7989,11
1732,T,7995,0,0,0,0,7994,7994,1
1733,G,7995,0,0,7994,0,0,7994,1
1733,G,8001,1,0,7999,0,1,7999,2
1734,A,8001,7998,0,1,0,1,7998,3
1734,T,7992,0,1,0,0,7989,7989,3
1735,G,7992,1,0,7991,0,0,7991,1
1735,G,8002,0,0,8002,0,0,8002,0
1736,C,7992,0,7900,2,0,1,7900,92
1736,T,8002,0,0,1,0,7995,7995,7
1737,C,7994,1,7991,0,0,2,7991,3
1737,T,8000,0,2,0,0,7998,7998,2
1738,C,7998,0,7998,0,0,0,7998,0
1738,G,8001,0,0,8001,0,0,8001,0
1739,C,7996,0,7996,0,0,0,7996,0
1739,T,8000,0,0,1,0,7995,7995,5
1740,T,7998,1,1,0,0,7996,7996,2
1740,T,8000,0,0,0,0,8000,8000,0
1741,A,7999,7997,0,0,0,1,7997,2
1741,C,7998,1,7993,0,0,1,7993,5
1742,C,7989,1,7987,0,0,1,7987,2
1742,G,7998,1,0,7933,0,0,7933,65
1743,G,7989,3,0,7986,0,0,7986,3
1743,G,7999,0,0,7998,0,1,7998,1
1744,A,7991,7991,0,0,0,0,7991,0
1744,G,7999,0,0,7998,0,0,7998,1
1745,C,7992,1,7991,0,0,0,7991,1
1745,C,7997,0,7993,0,0,0,7993,4
1746,A,7996,7995,0,0,0,1,7995,1
1746,C,7998,1,7993,1,0,1,7993,5
1747,G,7984,0,1,7974,0,1,7974,10
1747,T,7994,0,0,0,0,7956,7956,38
1748,G,7999,1,0,7997,0,1,7997,2
1748,T,7996,0,0,0,0,7996,7996,0
1749,A,7999,7999,0,0,0,0,7999,0
1749,T,7996,0,0,0,0,7996,7996,0
1750,T,7996,0,1,1,0,7993,7993,3
1750,T,8000,0,0,1,0,7992,7992,8
1751,G,7999,1,0,7982,0,1,7982,17
1751,T,7996,0,0,0,0,7996,7996,0
1752,G,7993,1,0,7992,0,0,7992,1
1752,G,8000,3,0,7994,0,2,7994,6
1753,A,7995,7974,0,0,0,0,7974,21
1753,C,7998,0,7996,0,0,1,7996,2
1754,A,7996,7996,0,0,0,0,7996,0
1754,T,7998,0,1,0,0,7996,7996,2
1755,A,7980,7980,0,0,0,0,7980,0
1755,A,7999,7999,0,0,0,0,7999,0
1756,G,8000,0,0,8000,0,0,8000,0
1756,T,7995,0,0,0,0,7994,7994,1
1757,C,7993,0,7991,0,0,1,7991,2
1757,T,7999,0,0,0,0,7999,7999,0
1758,C,7998,0,7941,0,0,1,7941,57
1758,T,7988,1,1,0,0,7986,7986,2
1759,A,7982,7980,0,0,0,0,7980,2
1759,C,8000,1,7998,0,0,1,7998,2
1760,C,7982,1,7973,0,0,1,7973,9
1760,C,8000,0,8000,0,0,0,8000,0
1761,C,7951,0,7950,0,0,1,7950,1
1761,G,8001,1,0,7999,0,0,7999,2
1762,G,7952,1,0,7936,0,0,7936,16
1762,T,8001,0,1,2,0,7984,7984,17
1763,G,7974,1,0,7973,0,0,7973,1
1763,T,8002,0,1,0,0,8001,8001,1
1764,C,7975,0,7974,0,0,1,7974,1
1764,G,8002,1,1,8000,0,0,8000,2
1765,A,7974,7972,0,1,0,0,7972,2
1765,A,7990,7990,0,0,0,0,7990,0
1766,T,7970,1,0,0,0,7960,7960,10
1766,T,7992,2,0,0,0,7943,7943,49
1767,T,7970,0,1,0,0,7969,7969,1
1767,T,7992,0,0,0,0,7992,7992,0
1768,G,7969,1,0,7964,0,0,7964,5
1768,T,7991,0,0,0,0,7991,7991,0
1769,G,7969,0,0,7969,0,0,7969,0
1769,T,7990,0,1,0,0,7987,7987,3
1770,C,7967,0,7967,0,0,0,7967,0
1770,G,7988,0,0,7980,0,0,7980,8
1771,G,7965,1,0,7962,0,1,7962,3
1771,G,7992,0,0,7992,0,0,7992,0
1772,C,7966,0,7966,0,0,0,7966,0
1772,T,7993,0,0,0,0,7993,7993,0
1773,A,7962,7959,1,1,0,0,7959,3
1773,G,7994,1,0,7993,0,0,7993,1
1774,C,7994,0,7990,0,0,1,7990,4
1774,G,7975,1,0,7974,0,0,7974,1
1775,A,7976,7632,0,0,0,0,7632,344
1775,C,7994,1,7993,0,0,0,7993,1
1776,A,7979,7978,0,0,0,1,7978,1
1776,A,7997,7963,0,0,0,0,7963,34
1777,A,7980,7979,1,0,0,0,7979,1
1777,A,8000,8000,0,0,0,0,8000,0
1778,A,7982,7981,1,0,0,0,7981,1
1778,A,8001,7999,0,0,0,0,7999,2
1779,A,7983,7983,0,0,0,0,7983,0
1779,A,8000,7998,2,0,0,0,7998,2
1780,A,7983,7983,0,0,0,0,7983,0
1780,C,8000,1,7999,0,0,0,7999,1
1781,A,7983,7982,0,0,0,0,7982,1
1781,A,8001,7995,0,0,0,0,7995,6
1782,A,8002,8002,0,0,0,0,8002,0
1782,T,7984,0,0,0,0,7984,7984,0
1783,A,8002,8002,0,0,0,0,8002,0
1783,G,7990,1,1,7987,0,0,7987,3
1784,C,7986,1,7971,0,0,1,7971,15
1784,C,8003,0,8001,0,0,0,8001,2
1785,C,7983,2,7981,0,0,0,7981,2
1785,T,8003,0,0,0,0,8003,8003,0
1786,C,8004,1,7966,0,0,0,7966,38
1786,T,7983,0,0,0,0,7983,7983,0
1787,C,8000,0,8000,0,0,0,8000,0
1787,G,7985,1,0,7984,0,0,7984,1
1788,A,7999,7999,0,0,0,0,7999,0
1788,C,8001,0,8001,0,0,0,8001,0
1789,A,8002,8000,1,0,0,0,8000,2
1789,T,7999,0,0,0,0,7999,7999,0
1790,G,8000,0,0,8000,0,0,8000,0
1790,T,8002,1,0,0,0,7994,7994,8
1791,C,7998,0,7996,2,0,0,7996,2
1791,T,8000,1,0,0,0,7999,7999,1
1792,G,7996,0,1,7994,0,0,7994,2
1792,G,8001,1,0,8000,0,0,8000,1
1793,A,7994,7994,0,0,0,0,7994,0
1793,A,7998,7994,1,3,0,0,7994,4
1794,C,7999,0,7996,0,0,2,7996,3
1794,C,8000,0,8000,0,0,0,8000,0
1795,G,7988,2,0,7986,0,0,7986,2
1795,G,7999,3,0,7995,0,0,7995,4
1796,C,8000,0,8000,0,0,0,8000,0
1796,T,7996,0,0,0,0,7996,7996,0
1797,C,7998,2,7993,0,0,2,7993,5
1797,T,7985,0,0,2,0,7983,7983,2
1798,A,7996,7992,0,0,0,0,7992,4
1798,G,7997,1,0,7995,0,0,7995,2
1799,A,7999,7997,0,0,0,1,7997,2
1799,C,7996,1,7992,1,0,2,7992,4
1800,G,7999,0,1,7998,0,0,7998,1
1800,T,7999,0,0,1,0,7998,7998,1
1801,C,7999,0,7996,0,0,1,7996,3
1801,G,7996,0,0,7939,0,0,7939,57
1802,G,7997,0,0,15992,0,0,15992,-7995
1803,G,7984,0,0,7984,0,0,7984,0
1803,T,7998,1,0,0,0,7996,7996,2
1804,C,7999,0,7999,0,0,0,7999,0
1804,G,7984,0,0,7982,0,0,7982,2
1805,T,7972,0,0,0,0,7970,7970,2
1805,T,7999,1,0,0,0,7991,7991,8
1806,G,7969,3,2,7956,0,0,7956,13
1806,T,8000,0,0,0,0,8000,8000,0
1807,A,7998,7996,0,0,0,0,7996,2
1807,G,7970,1,0,7968,0,1,7968,2
1808,A,7965,7964,0,0,0,0,7964,1
1808,T,7996,1,0,0,0,7995,7995,1
1809,A,7994,7992,0,0,0,0,7992,2
1809,G,7988,1,0,7987,0,0,7987,1
1810,A,7988,7988,0,0,0,0,7988,0
1810,C,7993,1,7990,0,0,1,7990,3
1811,C,7995,0,7995,0,0,0,7995,0
1811,T,7959,0,0,1,0,7958,7958,1
1812,C,7982,0,7959,0,0,0,7959,23
1812,T,7989,0,0,0,0,7983,7983,6
1813,C,7973,0,7973,0,0,0,7973,0
1813,T,7991,0,0,0,0,7990,7990,1
1814,C,7972,0,7971,1,0,0,7971,1
1814,G,7993,0,0,7981,0,0,7981,12
1815,A,7998,7995,0,0,0,1,7995,3
1815,G,7995,0,0,7995,0,0,7995,0
1816,A,7994,7973,0,2,0,1,7973,21
1816,C,7995,0,7993,0,0,1,7993,2
1817,A,7994,7994,0,0,0,0,7994,0
1817,A,7995,7994,0,1,0,0,7994,1
1818,A,7988,7987,0,1,0,0,7987,1
1818,T,7993,0,0,0,0,7993,7993,0
1819,A,7970,7969,0,0,0,1,7969,1
1819,T,7983,1,7,0,0,7975,7975,8
1820,C,7985,0,7917,0,0,1,7917,68
1820,T,7975,0,0,0,0,7975,7975,0
1821,C,7981,0,7981,0,0,0,7981,0
1821,G,7971,1,0,7969,0,0,7969,2
1822,C,7970,0,7964,0,0,1,7964,6
1822,C,7985,0,7984,0,0,1,7984,1
1823,C,7967,0,7967,0,0,0,7967,0
1823,C,7981,0,7979,1,0,1,7979,2
1824,A,7968,7968,0,0,0,0,7968,0
1824,G,7981,0,0,7979,0,0,7979,2
1825,G,7966,0,0,7965,0,0,7965,1
1825,T,7981,1,0,0,0,7980,7980,1
1826,A,7977,7977,0,0,0,0,7977,0
1826,G,7996,1,0,7995,0,0,7995,1
1827,A,7998,7998,0,0,0,0,7998,0
1827,T,7979,0,0,0,0,7972,7972,7
1828,G,7999,0,0,7997,0,0,7997,2
1828,T,7973,2,1,1,0,7969,7969,4
1829,C,7979,0,7978,0,0,1,7978,1
1829,T,7997,0,1,0,0,7996,7996,1
1830,A,7975,7973,1,0,0,0,7973,2
1830,C,7995,0,7993,1,0,0,7993,2
1831,A,7995,7977,0,0,0,0,7977,18
1831,G,7980,0,0,7980,0,0,7980,0
1832,A,7996,7995,0,1,0,0,7995,1
1832,C,7982,0,7980,0,0,2,7980,2
1833,A,7977,7971,0,1,0,0,7971,6
1833,A,7997,7997,0,0,0,0,7997,0
1834,A,7980,7980,0,0,0,0,7980,0
1834,C,8000,0,7991,0,0,0,7991,9
1835,C,7991,0,7989,0,0,1,7989,2
1835,C,7995,0,7994,0,0,0,7994,1
1836,G,7996,1,0,7995,0,0,7995,1
1836,G,7998,0,0,7991,0,0,7991,7
1837,C,7995,0,7995,0,0,0,7995,0
1837,G,7999,0,0,7999,0,0,7999,0
1838,A,7994,7993,0,1,0,0,7993,1
1838,T,7996,0,1,0,0,7994,7994,2
1839,A,8000,7999,0,1,0,0,7999,1
1839,T,7995,0,0,0,0,7995,7995,0
1840,A,7993,7993,0,0,0,0,7993,0
1840,T,8001,0,0,0,0,8001,8001,0
1841,C,7994,0,7992,0,0,0,7992,2
1841,C,8002,0,7996,0,0,1,7996,6
1842,C,8002,0,8002,0,0,0,8002,0
1842,G,7998,0,0,7993,0,0,7993,5
1843,A,7986,7985,0,0,0,0,7985,1
1843,G,7999,1,0,7998,0,0,7998,1
1844,C,7992,0,7989,0,0,0,7989,3
1844,C,7998,1,7995,1,0,1,7995,3
1845,G,7993,0,0,7993,0,0,7993,0
1845,T,7967,0,0,1,0,7965,7965,2
1846,C,7998,0,7953,0,0,0,7953,45
1846,T,7996,0,8,0,0,7988,7988,8
1847,C,7999,0,15931,0,0,1,15931,-7932
1848,C,7982,0,7981,0,0,1,7981,1
1848,C,8000,1,7999,0,0,0,7999,1
1849,A,7983,7983,0,0,0,0,7983,0
1849,C,8000,1,7997,0,0,2,7997,3
1850,C,8000,0,8000,0,0,0,8000,0
1850,T,8000,1,0,2,0,7993,7993,7
1851,A,7996,7991,1,2,0,0,7991,5
1851,T,8000,0,0,0,0,7999,7999,1
1852,A,7996,7995,0,0,0,0,7995,1
1852,G,8000,0,0,8000,0,0,8000,0
1853,A,8000,7998,0,2,0,0,7998,2
1853,C,7997,2,7995,0,0,0,7995,2
1854,T,7987,0,0,0,0,7984,7984,3
1854,T,7998,0,0,3,0,7995,7995,3
1855,G,7984,0,0,7984,0,0,7984,0
1855,T,7981,0,0,1,0,7980,7980,1
1856,G,7998,1,1,7996,0,0,7996,2
1856,T,7975,0,1,0,0,7973,7973,2
1857,A,7947,7947,0,0,0,0,7947,0
1857,C,7999,0,7982,0,0,1,7982,17
1858,C,7964,0,7964,0,0,0,7964,0
1858,C,8000,0,7999,0,0,1,7999,1
1859,C,7999,0,7999,0,0,0,7999,0
1859,T,7943,1,0,1,0,7941,7941,2
1860,A,7995,7992,1,1,0,0,7992,3
1860,G,7979,2,0,7976,0,0,7976,3
1861,C,7976,1,7964,1,0,0,7964,12
1861,C,7999,0,7997,0,0,1,7997,2
1862,C,7975,0,7973,0,0,1,7973,2
1862,T,8000,0,0,0,0,7999,7999,1
1863,A,7975,7935,1,0,0,0,7935,40
1863,T,8001,0,1,0,0,8000,8000,1
1864,A,7976,7976,0,0,0,0,7976,0
1864,C,8002,0,7999,0,0,0,7999,3
1865,A,7978,7978,0,0,0,0,7978,0
1865,C,7994,0,7994,0,0,0,7994,0
1866,A,7978,7978,0,0,0,0,7978,0
1866,A,7994,7990,2,0,0,1,7990,4
1867,C,7997,1,7989,0,0,0,7989,8
1867,T,7999,0,2,1,0,7996,7996,3
1868,A,7996,7996,0,0,0,0,7996,0
1868,C,7992,0,7992,0,0,0,7992,0
1869,C,7996,1,7993,0,0,1,7993,3
1869,G,7992,0,1,7991,0,0,7991,1
1870,C,7995,0,7994,0,0,0,7994,1
1870,G,7924,3,0,7920,0,1,7920,4
1871,A,7995,7994,0,0,0,0,7994,1
1871,T,7910,1,0,0,0,7909,7909,1
1872,G,7917,1,0,7914,0,0,7914,3
1872,T,7999,0,0,0,0,7999,7999,0
1873,C,8000,0,7998,0,0,1,7998,2
1873,T,7902,0,1,1,0,7900,7900,2
1874,A,8000,8000,0,0,0,0,8000,0
1874,C,7910,0,7901,0,0,2,7901,9
1875,C,7933,0,7933,0,0,0,7933,0
1875,C,8001,1,7991,5,0,0,7991,10
1876,C,7996,0,7996,0,0,0,7996,0
1876,T,7928,0,1,0,0,7926,7926,2
1877,A,7997,7994,0,0,0,2,7994,3
1877,C,7942,0,7939,0,0,1,7939,3
1878,C,7931,0,7931,0,0,0,7931,0
1878,T,7997,0,2,0,0,7995,7995,2
1879,G,7999,1,0,7997,0,0,7997,2
1879,T,7927,1,1,0,0,7923,7923,4
1880,G,8000,0,0,8000,0,0,8000,0
1880,T,7929,0,0,0,0,7929,7929,0
1881,A,7931,7931,0,0,0,0,7931,0
1881,T,7995,0,0,0,0,7993,7993,2
1882,A,7992,7992,0,0,0,0,7992,0
1882,C,7939,0,7934,0,0,0,7934,5
1883,A,7986,7985,0,0,0,1,7985,1
1883,C,7936,1,7933,1,0,1,7933,3
1884,A,7928,7928,0,0,0,0,7928,0
1884,T,7979,0,0,0,0,7979,7979,0
1885,A,7993,7991,0,1,0,0,7991,2
1885,G,7929,0,0,7927,0,2,7927,2
1886,A,7931,7912,0,0,0,1,7912,19
1886,G,7998,1,0,7996,0,1,7996,2
1887,A,7947,7946,0,0,0,1,7946,1
1887,C,7946,1,7943,0,0,2,7943,3
1888,A,7948,7946,0,0,0,2,7946,2
1888,G,7940,0,0,7940,0,0,7940,0
1889,A,7935,7934,0,0,0,0,7934,1
1889,T,7949,0,0,0,0,7931,7931,18
1890,T,7930,0,1,0,0,7929,7929,1
1890,T,7948,0,0,0,0,7948,7948,0
1891,G,7999,0,0,7999,0,0,7999,0
1891,T,7947,0,0,0,0,7946,7946,1
1892,A,7949,7948,0,0,0,0,7948,1
1892,A,8000,8000,0,0,0,0,8000,0
1893,C,8001,0,8001,0,0,0,8001,0
1893,T,7983,0,0,0,0,7983,7983,0
1894,C,7999,0,7994,0,0,0,7994,5
1894,T,7994,0,0,0,0,7993,7993,1
1895,A,7995,7991,0,1,0,0,7991,4
1895,C,7999,0,7999,0,0,0,7999,0
1896,A,7999,7994,2,0,0,3,7994,5
1896,T,7994,0,0,0,0,7991,7991,3
1897,T,7994,0,0,0,0,7994,7994,0
1897,T,7999,0,1,0,0,7998,7998,1
1898,A,7996,7991,0,0,0,0,7991,5
1898,A,8000,8000,0,0,0,0,8000,0
1899,A,7996,7996,0,0,0,0,7996,0
1899,C,8001,2,7998,0,0,1,7998,3
1900,G,7972,0,0,7972,0,0,7972,0
1900,G,7999,0,0,7988,0,1,7988,11
1901,G,8000,1,0,7998,0,1,7998,2
1901,T,7999,0,0,0,0,7999,7999,0
1902,A,7956,7956,0,0,0,0,7956,0
1902,T,7989,0,1,0,0,7988,7988,1
1903,C,7982,0,7981,0,0,1,7981,1
1903,G,7976,0,0,7975,0,0,7975,1
1904,A,7988,7988,0,0,0,0,7988,0
1904,G,7982,3,0,7977,0,2,7977,5
1905,T,7981,0,0,0,0,7981,7981,0
1905,T,7982,0,1,0,0,7979,7979,3
1906,C,7999,1,7998,0,0,0,7998,1
1906,G,7984,0,0,7984,0,0,7984,0
1907,A,7999,7999,0,0,0,0,7999,0
1907,T,7970,0,2,0,0,7968,7968,2
1908,A,7970,7968,0,1,0,0,7968,2
1908,G,8000,0,0,7998,0,2,7998,2
1909,C,7974,0,7974,0,0,0,7974,0
1909,C,8000,0,7999,0,0,0,7999,1
1910,T,7952,0,0,0,0,7952,7952,0
1910,T,7986,0,0,0,0,7985,7985,1
1911,A,7998,7995,0,1,0,1,7995,3
1911,G,7975,0,0,7975,0,0,7975,0
1912,C,7970,0,7962,0,0,0,7962,8
1912,T,7998,0,0,1,0,7996,7996,2
1913,C,7971,1,7970,0,0,0,7970,1
1913,C,7998,0,7990,0,0,0,7990,8
1914,A,7994,7989,0,1,0,0,7989,5
1914,C,7999,1,7998,0,0,0,7998,1
1915,A,7988,7986,0,0,0,1,7986,2
1915,T,7988,2,1,0,0,7984,7984,4
1916,G,7993,0,0,7993,0,0,7993,0
1916,G,7999,1,0,7997,0,0,7997,2
1917,C,7984,0,7984,0,0,0,7984,0
1917,T,7998,0,0,0,0,7998,7998,0
1918,A,7982,7981,0,0,0,0,7981,1
1918,A,7996,7994,0,1,0,0,7994,2
1919,G,7994,0,0,7989,0,0,7989,5
1919,G,7999,1,0,7987,0,1,7987,12
1920,G,7987,0,0,7987,0,0,7987,0
1920,G,7993,0,0,7993,0,0,7993,0
1921,A,7991,7975,0,1,0,0,7975,16
1921,C,7986,0,7986,0,0,0,7986,0
1922,A,7992,7991,0,1,0,0,7991,1
1922,G,7981,0,0,7981,0,0,7981,0
1923,A,7981,7980,0,0,0,0,7980,1
1923,A,7988,7986,0,1,0,1,7986,2
1924,G,7999,0,0,7999,0,0,7999,0
1924,T,7994,1,0,0,0,7990,7990,4
1925,C,7995,0,7995,0,0,0,7995,0
1925,T,7995,0,0,0,0,7993,7993,2
1926,C,7998,0,7953,0,0,0,7953,45
1926,T,7997,0,1,0,0,7996,7996,1
1927,C,7998,0,7997,0,0,1,7997,1
1927,C,7999,0,7998,0,0,1,7998,1
1928,C,7993,0,7993,0,0,0,7993,0
1928,T,7994,0,0,0,0,7993,7993,1
1929,A,7994,7988,0,3,0,2,7988,6
1929,C,7995,0,7993,0,0,1,7993,2
1930,G,7995,1,0,7993,0,0,7993,2
1930,T,7994,0,0,0,0,7994,7994,0
1931,A,7994,7992,0,1,0,0,7992,2
1931,A,7999,7999,0,0,0,0,7999,0
1932,A,7997,7996,0,0,0,1,7996,1
1932,T,7999,0,0,0,0,7986,7986,13
1933,G,7990,1,0,7987,0,0,7987,3
1933,T,7999,0,0,0,0,7999,7999,0
1934,G,7997,0,1,7996,0,0,7996,1
1934,T,7998,0,0,0,0,7998,7998,0
1935,C,7997,0,7995,0,0,0,7995,2
1935,T,7975,1,2,0,0,7972,7972,3
1936,C,7969,0,7968,1,0,0,7968,1
1936,G,7998,1,0,7997,0,0,7997,1
1937,A,7970,7968,0,2,0,0,7968,2
1937,A,7999,7999,0,0,0,0,7999,0
1938,T,7971,0,0,2,0,7969,7969,2
1938,T,8000,0,0,0,0,7999,7999,1
1939,C,8001,0,8001,0,0,0,8001,0
1939,G,8000,1,1,7998,0,0,7998,2
1940,A,8000,7997,0,1,0,0,7997,3
1940,T,8001,0,2,0,0,7999,7999,2
1941,A,8000,7998,0,0,0,0,7998,2
1941,A,8001,8001,0,0,0,0,8001,0
1942,C,7998,0,7997,0,0,0,7997,1
1942,G,8002,0,0,8002,0,0,8002,0
1943,A,8003,8002,0,1,0,0,8002,1
1943,T,7914,0,1,1,0,7912,7912,2
1944,C,8004,0,8003,0,0,0,8003,1
1944,G,7941,2,0,7916,0,0,7916,25
1945,A,7991,7990,0,0,0,0,7990,1
1945,G,7934,1,0,7933,0,0,7933,1
1946,G,7999,1,0,7998,0,0,7998,1
1946,T,7998,0,0,0,0,7991,7991,7
1947,C,8000,0,7998,2,0,0,7998,2
1947,T,7998,0,1,0,0,7997,7997,1
1948,A,7984,7982,0,1,0,0,7982,2
1948,C,7999,0,7983,0,0,0,7983,16
1949,C,8000,1,7999,0,0,0,7999,1
1949,T,7985,0,0,1,0,7984,7984,1
1950,A,7983,7978,0,1,0,1,7978,5
1950,T,7989,1,0,0,0,7976,7976,13
1951,A,7999,7997,0,2,0,0,7997,2
1951,T,7999,0,0,0,0,7999,7999,0
1952,T,8000,0,0,1,0,15999,15999,-7999
1953,A,7999,7995,0,1,0,0,7995,4
1953,G,7993,1,0,7992,0,0,7992,1
1954,A,7999,7998,0,1,0,0,7998,1
1954,C,7994,0,7990,1,0,0,7990,4
1955,C,7963,0,7961,1,0,1,7961,2
1955,T,7993,0,0,0,0,7991,7991,2
1956,A,7963,7962,0,1,0,0,7962,1
1956,G,8000,0,0,7978,0,1,7978,22
1957,G,7963,0,0,7953,0,1,7953,10
1957,G,7998,0,0,7997,0,1,7997,1
1958,G,7964,0,0,7964,0,0,7964,0
1958,T,7971,1,1,0,0,7968,7968,3
1959,C,7964,0,7962,1,0,0,7962,2
1959,C,7976,0,7976,0,0,0,7976,0
1960,G,7947,1,1,7921,0,1,7921,26
1960,T,7974,0,0,0,0,7945,7945,29
1961,G,7982,1,0,7981,0,0,7981,1
1961,T,8000,0,1,0,0,7999,7999,1
1962,G,7984,1,0,7982,0,1,7982,2
1962,T,8000,0,0,0,0,8000,8000,0
1963,C,7995,2,7985,1,0,2,7985,10
1963,T,8001,0,0,0,0,8001,8001,0
1964,C,8000,0,7999,1,0,0,7999,1
1964,C,8002,2,7999,0,0,0,7999,3
1965,A,8000,7998,0,2,0,0,7998,2
1965,T,7999,1,0,0,0,7998,7998,1
1966,G,8000,0,0,7991,0,0,7991,9
1966,T,8001,0,0,2,0,7995,7995,6
1967,G,7999,0,0,7997,0,1,7997,2
1967,T,8000,1,1,1,0,7997,7997,3
1968,A,7998,7997,0,0,0,0,7997,1
1968,T,8001,0,1,1,0,7999,7999,2
1969,A,8002,8002,0,0,0,0,8002,0
1969,C,7997,0,7995,1,0,0,7995,2
1970,A,7976,7974,0,1,0,0,7974,2
1970,C,8001,0,7993,1,0,2,7993,8
1971,C,7994,0,7992,1,0,1,7992,2
1971,C,7999,0,7992,0,0,0,7992,7
1972,C,8000,0,8000,0,0,0,8000,0
1972,G,7995,0,0,7995,0,0,7995,0
1973,A,8001,8001,0,0,0,0,8001,0
1973,T,7996,0,0,0,0,7996,7996,0
1974,C,7995,1,7993,1,0,0,7993,2
1974,C,8003,1,8002,0,0,0,8002,1
1975,A,8000,7998,0,1,0,1,7998,2
1975,T,8002,1,0,0,0,8000,8000,2
1976,A,8002,8000,0,1,0,0,8000,2
1976,T,8000,0,0,0,0,7998,7998,2
1977,G,8002,1,0,7887,0,1,7887,115
1977,T,8000,0,0,2,0,7998,7998,2
1978,G,7985,0,0,7984,0,0,7984,1
1978,G,8001,1,0,7999,0,0,7999,2
1979,A,7999,7997,0,1,0,1,7997,2
1979,G,7998,2,0,7995,0,1,7995,3
1980,C,7999,0,7998,1,0,0,7998,1
1980,G,7928,0,0,7927,0,1,7927,1
1981,G,7998,1,0,7997,0,0,7997,1
1981,T,7921,0,1,1,0,7919,7919,2
1982,C,7932,0,7930,0,0,1,7930,2
1982,T,7993,0,0,0,0,7990,7990,3
1983,A,7927,7927,0,0,0,0,7927,0
1983,C,7996,0,7994,0,0,1,7994,2
1984,A,7998,7994,0,0,0,0,7994,4
1984,G,7993,0,0,7993,0,0,7993,0
1985,A,7999,15996,0,2,0,0,15996,-7997
1986,A,7997,7997,0,0,0,0,7997,0
1986,T,8000,0,0,0,0,8000,8000,0
1987,A,7993,7990,0,1,0,0,7990,3
1987,G,7998,0,0,7998,0,0,7998,0
1988,G,7999,0,0,7773,0,1,7773,226
1988,T,7990,0,0,0,0,7990,7990,0
1989,A,7973,7970,0,0,0,0,7970,3
1989,G,7970,0,0,7970,0,0,7970,0
1990,G,7975,0,0,7974,0,0,7974,1
1990,G,7978,1,0,7977,0,0,7977,1
1991,G,7972,0,0,7972,0,0,7972,0
1991,T,7973,0,1,0,0,7972,7972,1
1992,G,7971,0,1,7970,0,0,7970,1
1992,T,7986,0,0,0,0,7986,7986,0
1993,C,7965,0,7960,2,0,3,7960,5
1993,C,7970,0,7970,0,0,0,7970,0
1994,A,7969,7969,0,0,0,0,7969,0
1994,G,7996,1,0,7994,0,0,7994,2
1995,T,7971,0,0,0,0,7971,7971,0
1995,T,7999,0,0,1,0,7998,7998,1
1996,A,8000,7997,0,1,0,0,7997,3
1996,C,7970,0,7969,0,0,1,7969,1
1997,A,7969,7930,1,1,0,0,7930,39
1997,C,8001,1,7998,1,0,0,7998,3
1998,A,7973,7973,0,0,0,0,7973,0
1998,T,7992,0,2,1,0,7986,7986,6
1999,A,7987,7986,1,0,0,0,7986,1
1999,T,7998,0,0,1,0,7997,7997,1
2000,C,7999,0,7998,0,0,1,7998,1
2000,G,7997,0,0,7986,0,1,7986,11
2001,G,7997,0,0,7996,0,1,7996,1
2001,T,7997,0,0,0,0,7980,7980,17
2002,C,7998,0,7996,1,0,1,7996,2
2002,T,7998,0,0,0,0,7998,7998,0
2003,A,7994,7989,0,0,0,3,7989,5
2003,T,7997,0,0,0,0,7996,7996,1
2004,C,7998,0,7996,0,0,1,7996,2
2004,T,7991,0,1,0,0,7989,7989,2
2005,A,7998,7997,0,0,0,0,7997,1
2005,T,7999,0,0,0,0,7995,7995,4
2006,T,7995,0,1,0,0,7994,7994,1
2006,T,8000,0,0,0,0,8000,8000,0
2007,C,8001,0,7953,0,0,1,7953,48
2007,G,7999,0,0,7998,0,0,7998,1
2008,A,7998,7997,0,1,0,0,7997,1
2008,C,7998,0,7998,0,0,0,7998,0
2009,C,7999,0,7997,0,0,2,7997,2
2009,T,7997,0,2,0,0,7994,7994,3
2010,A,7982,7978,0,0,0,2,7978,4
2010,T,7998,0,2,0,0,7996,7996,2
2011,C,7999,0,15972,0,0,4,15972,-7973
2012,A,7993,7990,0,0,0,2,7990,3
2012,C,7997,0,7997,0,0,0,7997,0
2013,C,7995,1,7993,0,0,1,7993,2
2013,C,7999,0,7999,0,0,0,7999,0
2014,T,7978,0,0,0,0,7973,7973,5
2014,T,7996,1,0,0,0,7995,7995,1
2015,A,7998,7992,0,1,0,1,7992,6
2015,T,7970,0,1,0,0,7969,7969,1
2016,A,7999,7999,0,0,0,0,7999,0
2016,G,7973,0,0,7972,0,0,7972,1
2017,A,7994,7994,0,0,0,0,7994,0
2017,T,7999,0,0,0,0,7997,7997,2
2018,C,7998,0,7998,0,0,0,7998,0
2018,T,7995,0,0,1,0,7993,7993,2
2019,G,7997,0,1,7995,0,0,7995,2
2019,T,7991,0,1,0,0,7989,7989,2
2020,C,7984,0,7984,0,0,0,7984,0
2020,T,7989,0,1,0,0,7988,7988,1
2021,A,7982,7981,0,1,0,0,7981,1
2021,A,7995,7993,0,0,0,0,7993,2
2022,C,7994,0,7993,0,0,1,7993,1
2022,T,7992,0,0,0,0,7987,7987,5
2023,T,7980,0,2,0,0,7978,7978,2
2023,T,7999,0,0,1,0,7998,7998,1
2024,G,7998,1,0,7997,0,0,7997,1
2024,G,7999,0,0,7991,0,0,7991,8
2025,C,7998,0,7988,0,0,0,7988,10
2025,G,7998,0,0,7997,0,1,7997,1
2026,C,7986,0,7985,0,0,0,7985,1
2026,T,7986,0,1,0,0,7982,7982,4
2027,A,7985,7980,0,0,0,0,7980,5
2027,T,7986,0,0,0,0,7986,7986,0
2028,A,7986,7985,0,0,0,1,7985,1
2028,A,7998,7998,0,0,0,0,7998,0
2029,C,7998,0,7994,0,0,0,7994,4
2029,G,7997,1,0,7994,0,1,7994,3
2030,C,7996,0,7995,0,0,1,7995,1
2030,T,7985,1,0,0,0,7984,7984,1
2031,G,7993,0,0,7979,0,0,7979,14
2031,T,7995,0,1,0,0,7992,7992,3
2032,G,7996,0,0,7996,0,0,7996,0
2032,T,7991,0,0,0,0,7990,7990,1
2033,G,7995,2,0,7992,0,0,7992,3
2033,G,7997,0,0,7962,0,2,7962,35
2034,C,7997,0,7996,0,0,1,7996,1
2034,G,7997,0,0,7996,0,1,7996,1
2035,A,7995,7992,0,1,0,1,7992,3
2035,G,7998,0,0,7998,0,0,7998,0
2036,C,7995,0,7995,0,0,0,7995,0
2036,G,7999,0,0,7999,0,0,7999,0
2037,T,7971,0,2,1,0,7968,7968,3
2037,T,7999,0,0,0,0,7987,7987,12
2038,A,7989,7989,0,0,0,0,7989,0
2038,T,7998,0,0,0,0,7998,7998,0
2039,T,7990,0,0,0,0,7990,7990,0
2039,T,7999,0,1,0,0,7997,7997,2
2040,A,7999,7999,0,0,0,0,7999,0
2040,C,7990,0,7989,0,0,1,7989,1
2041,C,8000,0,7998,0,0,0,7998,2
2041,G,7991,1,0,7990,0,0,7990,1
2042,A,7998,7982,0,0,0,0,7982,16
2042,C,7999,0,7998,1,0,0,7998,1
2043,A,7999,7999,0,0,0,0,7999,0
2043,G,8000,1,0,7998,0,1,7998,2
2044,A,7999,7999,0,0,0,0,7999,0
2044,T,8002,0,0,1,0,8001,8001,1
2045,A,7984,7973,0,0,0,1,7973,11
2045,C,8000,1,7999,0,0,0,7999,1
2046,A,7984,7983,0,0,0,1,7983,1
2046,T,8000,0,1,0,0,7995,7995,5
2047,A,8000,7996,0,0,0,3,7996,4
2047,T,7998,0,2,0,0,7996,7996,2
2048,A,7999,7991,0,0,0,0,7991,8
2048,T,8000,0,0,0,0,8000,8000,0
2049,A,7982,7982,0,0,0,0,7982,0
2049,A,8000,8000,0,0,0,0,8000,0
2050,C,7990,0,7987,0,0,0,7987,3
2050,T,8000,0,0,0,0,7995,7995,5
2051,T,7977,0,0,1,0,7975,7975,2
2051,T,7998,0,0,0,0,7998,7998,0
2052,A,7998,7994,0,0,0,1,7994,4
2052,C,7984,0,7976,0,0,0,7976,8
2053,A,7999,7998,0,1,0,0,7998,1
2053,C,7974,1,7972,0,0,0,7972,2
2054,A,7981,7979,1,0,0,0,7979,2
2054,C,8000,0,7995,0,0,1,7995,5
2055,C,7996,1,7995,0,0,0,7995,1
2055,C,7999,3,7976,0,0,0,7976,23
2056,A,7983,7981,0,0,0,0,7981,2
2056,C,7992,1,7991,0,0,0,7991,1
2057,C,7994,1,7990,0,0,2,7990,4
2057,G,7982,0,0,7982,0,0,7982,0
2058,A,7996,7995,0,0,0,0,7995,1
2058,T,7982,0,0,1,0,7981,7981,1
2059,C,7992,0,7992,0,0,0,7992,0
2059,T,7996,0,0,0,0,7988,7988,8
2060,A,7991,7987,0,0,0,0,7987,4
2060,T,7995,0,0,0,0,7995,7995,0
2061,A,7999,7999,0,0,0,0,7999,0
2061,G,7996,2,0,7994,0,0,7994,2
2062,A,7997,7997,0,0,0,0,7997,0
2062,G,8000,0,0,7999,0,0,7999,1
2063,C,7998,0,7996,0,0,2,7996,2
2063,T,7996,0,0,0,0,7995,7995,1
2064,C,7998,0,7997,0,0,1,7997,1
2064,G,7990,0,0,7990,0,0,7990,0
2065,A,7996,7995,1,0,0,0,7995,1
2065,T,7992,0,0,0,0,7992,7992,0
2066,C,7996,0,7994,0,0,1,7994,2
2066,G,7998,0,0,7997,0,0,7997,1
2067,A,7996,7986,0,0,0,0,7986,10
2067,C,7999,0,7996,0,0,2,7996,3
2068,A,7999,7999,0,0,0,0,7999,0
2068,T,8000,1,0,0,0,7998,7998,2
2069,A,8000,8000,0,0,0,0,8000,0
2069,T,8000,0,0,1,0,7999,7999,1
2070,C,7998,0,7997,0,0,0,7997,1
2070,G,8000,1,0,7992,0,0,7992,8
2071,G,8001,0,0,8001,0,0,8001,0
2071,T,7988,0,0,0,0,7984,7984,4
2072,A,7996,7983,0,0,0,0,7983,13
2072,T,7993,0,1,0,0,7992,7992,1
2073,A,7998,7996,1,1,0,0,7996,2
2073,G,7994,1,0,7989,0,0,7989,5
2074,A,7998,7998,0,0,0,0,7998,0
2074,G,7994,0,1,7993,0,0,7993,1
2075,C,7995,0,7993,0,0,1,7993,2
2075,G,7997,0,0,7996,0,0,7996,1
2076,G,7998,2,0,7996,0,0,7996,2
2076,T,7993,0,1,0,0,7992,7992,1
2077,A,7997,7997,0,0,0,0,7997,0
2077,C,8000,0,7960,0,0,0,7960,40
2078,C,7999,0,7999,0,0,0,7999,0
2078,G,7999,0,0,7997,0,0,7997,2
2079,A,8000,7999,1,0,0,0,7999,1
2079,C,7993,0,7993,0,0,0,7993,0
2080,T,7992,2,0,0,0,7990,7990,2
2080,T,8000,0,1,0,0,7999,7999,1
2081,A,7998,7998,0,0,0,0,7998,0
2081,C,8001,0,8000,0,0,1,8000,1
2082,G,8001,2,0,7999,0,0,7999,2
2082,T,7996,0,1,0,0,7991,7991,5
2083,A,8002,8002,0,0,0,0,8002,0
2083,T,7998,0,1,1,0,7996,7996,2
2084,C,8002,0,8002,0,0,0,8002,0
2084,G,7977,0,0,7969,0,1,7969,8
2085,G,8000,0,1,7999,0,0,7999,1
2085,T,8002,0,0,1,0,7995,7995,7
2086,C,7995,1,7990,1,0,1,7990,5
2086,T,8002,0,0,0,0,8002,8002,0
2087,G,7997,0,0,7995,0,1,7995,2
2087,G,8003,1,0,8001,0,1,8001,2
2088,T,7975,0,0,0,0,7974,7974,1
2088,T,8000,0,0,0,0,8000,8000,0
2089,C,8000,0,7999,0,0,0,7999,1
2089,T,7991,0,0,0,0,7991,7991,0
2090,A,7999,7998,0,0,0,1,7998,1
2090,T,7997,0,0,1,0,7996,7996,1
2091,C,8000,0,8000,0,0,0,8000,0
2091,G,7998,0,0,7976,0,1,7976,22
2092,G,7995,0,0,7995,0,0,7995,0
2092,T,8001,0,0,0,0,8000,8000,1
2093,A,8001,8001,0,0,0,0,8001,0
2093,G,7994,0,0,7994,0,0,7994,0
2094,T,7995,0,0,1,0,7977,7977,18
2094,T,7996,0,0,0,0,7995,7995,1
2095,G,8000,2,0,7981,0,0,7981,19
2095,T,7991,0,1,0,0,7990,7990,1
2096,G,8001,0,0,8000,0,1,8000,1
2096,T,7991,0,1,0,0,7990,7990,1
2097,C,7994,1,7993,0,0,0,7993,1
2097,G,8001,0,0,8000,0,0,8000,1
2098,A,7991,7989,0,0,0,0,7989,2
2098,G,7994,0,0,7994,0,0,7994,0
2099,A,7985,7985,0,0,0,0,7985,0
2099,A,7994,7994,0,0,0,0,7994,0
2100,C,7993,1,7990,0,0,2,7990,3
2100,C,7994,0,7994,0,0,0,7994,0
2101,A,7996,7994,0,1,0,0,7994,2
2101,T,7984,0,1,1,0,7982,7982,2
2102,A,7989,7985,1,3,0,0,7985,4
2102,T,7996,0,1,0,0,7994,7994,2
2103,A,7996,7995,0,0,0,0,7995,1
2103,C,7989,0,7987,0,0,2,7987,2
2104,C,7996,0,7996,0,0,0,7996,0
2104,G,7999,0,0,7999,0,0,7999,0
2105,C,7999,0,7997,0,0,1,7997,2
2105,G,7997,1,0,7996,0,0,7996,1
2106,T,7993,0,0,0,0,7993,7993,0
2106,T,7995,1,0,0,0,7994,7994,1
2107,C,7993,0,7993,0,0,0,7993,0
2107,C,7998,0,7997,0,0,0,7997,1
2108,A,7991,7991,0,0,0,0,7991,0
2108,A,7994,7993,0,0,0,1,7993,1
2109,G,7999,0,0,7999,0,0,7999,0
2109,T,7995,1,0,0,0,7994,7994,1
2110,A,8000,7989,0,1,0,0,7989,11
2110,T,7995,0,1,0,0,7994,7994,1
2111,A,7994,7993,0,1,0,0,7993,1
2111,A,7999,7998,0,0,0,0,7998,1
2112,T,7994,0,0,0,0,7990,7990,4
2112,T,7999,0,0,1,0,7989,7989,10
2113,T,7968,0,0,1,0,7967,7967,1
2113,T,7987,0,0,1,0,7986,7986,1
2114,G,7973,0,0,7972,0,0,7972,1
2114,G,7994,0,0,7994,0,0,7994,0
2115,A,7983,7982,0,0,0,0,7982,1
2115,C,7974,0,7972,1,0,0,7972,2
2116,C,7997,1,7992,0,0,3,7992,5
2116,G,7975,1,1,7973,0,0,7973,2
2117,G,8000,2,0,7997,0,0,7997,3
2117,T,7974,0,0,0,0,7974,7974,0
2118,C,7964,0,7963,0,0,1,7963,1
2118,T,7993,0,0,0,0,7992,7992,1
2119,A,7988,7987,0,0,0,1,7987,1
2119,C,7999,0,7998,0,0,0,7998,1
2120,A,7995,7990,0,1,0,1,7990,5
2120,G,7999,0,0,7997,0,0,7997,2
2121,A,7998,7996,0,0,0,2,7996,2
2121,T,7999,0,0,0,0,7998,7998,1
2122,C,7999,0,7999,0,0,0,7999,0
2122,T,7998,0,0,0,0,7996,7996,2
2123,A,7997,7994,0,0,0,0,7994,3
2123,G,7997,1,0,7958,0,0,7958,39
2124,A,7998,7997,0,0,0,1,7997,1
2124,G,7995,1,0,7994,0,0,7994,1
2125,G,7993,1,3,7989,0,0,7989,4
2125,G,7999,0,0,7998,0,0,7998,1
2126,C,7989,0,7980,7,0,0,7980,9
2126,T,7999,0,1,1,0,7991,7991,8
2127,G,7989,1,5,7794,0,0,7794,195
2127,T,8000,0,0,0,0,8000,8000,0
2128,C,7992,0,7991,0,0,1,7991,1
2128,G,7989,1,1,7987,0,0,7987,2
2129,G,7992,1,1,7990,0,0,7990,2
2129,G,7996,0,0,7996,0,0,7996,0
2130,A,7999,7997,1,0,0,1,7997,2
2130,G,7999,1,0,7997,0,1,7997,2
2131,G,8000,1,0,7999,0,0,7999,1
2131,T,7999,0,1,0,0,7997,7997,2
2132,C,7998,0,7998,0,0,0,7998,0
2132,T,7998,0,0,1,0,7996,7996,2
2133,C,7997,1,7995,1,0,0,7995,2
2133,T,7991,1,0,1,0,7989,7989,2
2134,G,7998,3,0,7987,0,0,7987,11
2134,G,8000,0,0,7999,0,0,7999,1
2135,G,7999,0,0,7999,0,0,7999,0
2135,T,8001,0,0,1,0,7996,7996,5
2136,T,7999,0,0,1,0,7997,7997,2
2136,T,8002,0,0,0,0,8002,8002,0
2137,C,8000,0,7993,0,0,1,7993,7
2137,G,8003,0,0,7991,0,0,7991,12
2138,C,7994,1,7993,0,0,0,7993,1
2138,G,8004,1,1,8001,0,1,8001,3
2139,G,8005,0,0,8003,0,1,8003,2
2139,T,7992,0,1,0,0,7991,7991,1
2140,C,7997,0,7996,0,0,0,7996,1
2140,T,7995,0,1,0,0,7994,7994,1
2141,G,7997,1,0,7994,0,0,7994,3
2141,G,7999,0,1,7998,0,0,7998,1
2142,C,8000,0,7998,1,0,1,7998,2
2142,G,7999,0,0,7999,0,0,7999,0
2143,T,7991,0,0,0,0,7991,7991,0
2143,T,7998,0,2,0,0,7994,7994,4
2144,A,7991,7990,1,0,0,0,7990,1
2144,C,7998,0,7996,0,0,2,7996,2
2145,A,7999,7998,0,0,0,0,7998,1
2145,T,7993,1,0,0,0,7991,7991,2
2146,G,8001,1,0,8000,0,0,8000,1
2146,T,7990,0,2,0,0,7988,7988,2
2147,C,8002,0,7995,0,0,1,7995,7
2147,G,7993,2,0,7991,0,0,7991,2
2148,C,7986,0,7985,0,0,1,7985,1
2148,C,8002,0,8002,0,0,0,8002,0
2149,A,7984,7981,0,0,0,1,7981,3
2149,A,8003,8001,0,0,0,1,8001,2
2150,C,7998,0,7980,0,0,0,7980,18
2150,G,8003,0,0,7998,0,0,7998,5
2151,C,7987,2,7985,0,0,0,7985,2
2151,G,8003,0,1,8002,0,0,8002,1
2152,C,7986,0,7985,1,0,0,7985,1
2152,C,7997,3,7988,2,0,0,7988,9
2153,G,7994,2,1,7974,0,0,7974,20
2153,G,7996,1,0,7993,0,1,7993,3
2154,G,7999,1,0,7998,0,0,7998,1
2154,T,7997,0,1,0,0,7989,7989,8
2155,G,7997,1,1,7995,0,0,7995,2
2155,T,7997,0,0,0,0,7996,7996,1
2156,C,7996,0,7993,0,0,2,7993,3
2156,C,8000,0,7994,0,0,0,7994,6
2157,C,8000,0,8000,0,0,0,8000,0
2157,T,7996,0,0,0,0,7995,7995,1
2158,A,8000,8000,0,0,0,0,8000,0
2158,C,7998,1,7986,0,0,1,7986,12
2159,C,7995,0,7993,0,0,1,7993,2
2159,T,8000,0,0,2,0,7985,7985,15
2160,G,7997,1,0,7995,0,0,7995,2
2160,T,8000,0,1,0,0,7999,7999,1
2161,A,7998,7994,1,0,0,2,7994,4
2161,T,8001,1,0,0,0,8000,8000,1
2162,A,8002,8001,0,0,0,0,8001,1
2162,T,7995,2,0,0,0,7984,7984,11
2163,C,8003,1,7996,0,0,0,7996,7
2163,T,7994,0,2,0,0,7992,7992,2
2164,A,7994,7993,0,1,0,0,7993,1
2164,C,7987,1,7986,0,0,0,7986,1
2165,C,7996,1,7993,0,0,0,7993,3
2165,G,7989,1,0,7988,0,0,7988,1
2166,G,7996,0,1,7994,0,1,7994,2
2166,T,7984,0,0,0,0,7984,7984,0
2167,A,7993,7993,0,0,0,0,7993,0
2167,A,7997,7993,0,0,0,1,7993,4
2168,A,7996,7995,0,0,0,1,7995,1
2168,G,7997,0,0,7994,0,1,7994,3
2169,G,8000,0,0,7999,0,0,7999,1
2169,T,7990,0,0,0,0,7974,7974,16
2170,T,7991,0,1,0,0,7990,7990,1
2170,T,8000,1,0,0,0,7997,7997,3
2171,T,7984,1,0,1,0,7982,7982,2
2171,T,7991,1,1,0,0,7989,7989,2
2172,A,7999,7998,1,0,0,0,7998,1
2172,C,7999,1,7996,0,0,1,7996,3
2173,A,8000,7998,1,1,0,0,7998,2
2173,T,7999,1,0,0,0,7998,7998,1
2174,G,8000,1,0,7999,0,0,7999,1
2174,T,8001,2,0,0,0,7974,7974,27
2175,T,7999,1,1,0,0,7997,7997,2
2175,T,8000,0,0,0,0,8000,8000,0
2176,A,7987,7986,0,0,0,0,7986,1
2176,T,7998,1,0,0,0,7997,7997,1
2177,A,7998,7978,0,3,0,2,7978,20
2177,A,8000,8000,0,0,0,0,8000,0
2178,A,7999,7999,0,0,0,0,7999,0
2178,C,7986,0,7983,0,0,0,7983,3
2179,A,7999,7996,1,0,0,2,7996,3
2179,G,7994,0,0,7993,0,1,7993,1
2180,C,7996,0,7996,0,0,0,7996,0
2180,T,8000,0,0,0,0,8000,8000,0
2181,C,7986,0,7986,0,0,0,7986,0
2181,G,7992,1,0,7984,0,1,7984,8
2182,A,7985,7983,0,0,0,1,7983,2
2182,G,8000,0,0,7999,0,0,7999,1
2183,A,7999,7986,0,0,0,0,7986,13
2183,T,7992,1,0,2,0,7989,7989,3
2184,A,8000,8000,0,0,0,0,8000,0
2184,G,7994,1,0,7991,0,0,7991,3
2185,C,8000,0,7998,0,0,1,7998,2
2185,T,7990,0,1,0,0,7987,7987,3
2186,G,7999,0,0,7999,0,0,7999,0
2186,T,7994,1,2,0,0,7991,7991,3
2187,A,8000,7998,0,0,0,0,7998,2
2187,C,7999,0,7997,0,0,0,7997,2
2188,C,7997,0,7996,0,0,1,7996,1
2188,G,7999,0,0,7997,0,1,7997,2
2189,A,7999,7995,0,0,0,2,7995,4
2189,C,8000,0,8000,0,0,0,8000,0
2190,A,7999,7973,0,0,0,0,7973,26
2190,T,7998,0,0,0,0,7996,7996,2
2191,A,7996,7995,0,1,0,0,7995,1
2191,A,7999,7999,0,0,0,0,7999,0
2192,A,7996,7996,0,0,0,0,7996,0
2192,T,7999,0,0,0,0,7999,7999,0
2193,A,7987,7986,0,0,0,0,7986,1
2193,A,7997,7996,0,1,0,0,7996,1
2194,G,7998,0,0,7991,0,0,7991,7
2194,T,7965,0,0,1,0,7963,7963,2
2195,G,7968,1,0,7940,0,1,7940,28
2195,G,7998,0,0,7997,0,0,7997,1
2196,C,7994,0,7989,0,0,0,7989,5
2196,G,7931,0,0,7931,0,0,7931,0
2197,C,7994,0,7993,0,0,0,7993,1
2197,G,7997,2,0,7993,0,2,7993,4
2198,A,7994,7994,0,0,0,0,7994,0
2198,C,7981,0,7981,0,0,0,7981,0
2199,G,7998,0,0,7998,0,0,7998,0
2199,T,7950,0,0,0,0,7950,7950,0
2200,A,7987,7987,0,0,0,0,7987,0
2200,C,7998,1,7991,0,0,5,7991,7
2201,A,7997,7959,1,0,0,0,7959,38
2201,T,7984,1,0,1,0,7982,7982,2
2202,A,7998,7998,0,0,0,0,7998,0
2202,G,7999,0,0,7999,0,0,7999,0
2203,A,7993,7992,0,1,0,0,7992,1
2203,A,8000,7998,0,0,0,0,7998,2
2204,A,7998,7996,0,1,0,1,7996,2
2204,A,8001,8000,0,1,0,0,8000,1
2205,C,7996,0,7994,0,0,0,7994,2
2205,G,7999,0,0,7994,0,0,7994,5
2206,G,7999,0,0,7999,0,0,7999,0
2206,T,7968,1,0,0,0,7967,7967,1
2207,A,7967,7961,0,1,0,1,7961,6
2207,C,7999,0,7982,0,0,0,7982,17
2208,A,7967,7966,0,1,0,0,7966,1
2208,C,7992,0,7991,0,0,0,7991,1
2209,A,7991,7990,0,1,0,0,7990,1
2209,T,7957,0,0,0,0,7956,7956,1
2210,G,7959,0,0,7959,0,0,7959,0
2210,G,7992,0,0,7988,0,1,7988,4
2211,A,7934,7934,0,0,0,0,7934,0
2211,G,7995,0,0,7995,0,0,7995,0
2212,A,7995,7990,0,0,0,0,7990,5
2212,C,7990,1,7952,0,0,0,7952,38
2213,A,7993,7993,0,0,0,0,7993,0
2213,C,7971,0,7971,0,0,0,7971,0
2214,C,7992,0,7992,0,0,0,7992,0
2214,C,7995,0,7988,0,0,0,7988,7
2215,C,7978,0,7978,0,0,0,7978,0
2215,C,7996,4,7990,0,0,2,7990,6
2216,G,7999,3,0,15995,0,0,15995,-7996
2217,T,8000,0,0,0,0,16000,16000,-8000
2218,A,8001,15915,0,0,0,1,15915,-7914
2219,A,8001,8001,0,0,0,0,8001,0
2219,A,8002,8002,0,0,0,0,8002,0
2220,A,8000,8000,0,0,0,0,8000,0
2220,T,8002,1,0,0,0,7997,7997,5
2221,A,8000,7999,0,0,0,1,7999,1
2221,T,8000,2,1,0,0,7997,7997,3
2222,A,7996,7992,1,2,0,0,7992,4
2222,G,8001,1,0,8000,0,0,8000,1
2223,A,7989,7988,1,0,0,0,7988,1
2223,G,7991,1,0,7959,0,0,7959,32
2224,G,7992,1,0,7991,0,0,7991,1
2224,T,7992,0,0,0,0,7989,7989,3
2225,C,7993,0,7983,0,0,2,7983,10
2225,T,7991,0,1,0,0,7989,7989,2
2226,A,7996,7996,0,0,0,0,7996,0
2226,C,7982,0,7981,0,0,1,7981,1
2227,C,7997,0,7996,0,0,1,7996,1
2227,G,7983,0,1,7982,0,0,7982,1
2228,C,7985,0,7981,1,0,2,7981,4
2228,T,7989,0,0,0,0,7989,7989,0
2229,A,7999,7999,0,0,0,0,7999,0
2229,G,7984,1,0,7982,0,0,7982,2
2230,T,7996,0,1,0,0,7990,7990,6
2230,T,7999,0,1,0,0,7991,7991,8
2231,T,7993,0,1,0,0,7992,7992,1
2231,T,7998,0,1,0,0,7997,7997,1
2232,A,7998,7992,0,1,0,0,7992,6
2232,G,7997,3,0,7994,0,0,7994,3
2233,A,7998,7996,0,1,0,1,7996,2
2233,C,7995,1,7991,0,0,2,7991,4
2234,T,7995,0,0,0,0,7995,7995,0
2234,T,7998,0,1,0,0,7997,7997,1
2235,A,7994,7989,0,1,0,0,7989,5
2235,G,7998,2,0,7986,0,0,7986,12
2236,A,7976,7975,1,0,0,0,7975,1
2236,G,7999,0,0,7999,0,0,7999,0
2237,C,7988,1,7984,0,0,1,7984,4
2237,C,7999,1,7995,1,0,1,7995,4
2238,G,7999,0,1,7995,0,2,7995,4
2238,T,7930,0,0,0,0,7930,7930,0
2239,A,7961,7961,0,0,0,0,7961,0
2239,T,7997,0,0,0,0,7930,7930,67
2240,G,7999,0,0,7997,0,1,7997,2
2240,T,7997,0,0,0,0,7997,7997,0
2241,T,7997,0,0,1,0,7996,7996,1
2241,T,8000,0,1,0,0,7999,7999,1
2242,C,8001,0,8001,0,0,0,8001,0
2242,T,7999,0,0,0,0,7999,7999,0
2243,A,8000,7996,0,0,0,0,7996,4
2243,T,8000,0,2,0,0,7997,7997,3
2244,A,8000,7999,0,1,0,0,7999,1
2244,C,8000,0,7987,0,0,1,7987,13
2245,C,8000,0,7999,0,0,1,7999,1
2245,T,8001,0,1,0,0,8000,8000,1
2246,A,7997,7992,0,1,0,2,7992,5
2246,A,8000,7995,0,2,0,0,7995,5
2247,A,7999,7997,0,0,0,2,7997,2
2247,T,7999,1,0,0,0,7998,7998,1
2248,A,7995,7993,0,0,0,2,7993,2
2248,T,7992,1,0,0,0,7989,7989,3
2249,C,7992,0,7991,0,0,1,7991,1
2249,G,7999,0,0,7989,0,2,7989,10
2250,A,7984,7979,0,0,0,0,7979,5
2250,G,7997,0,0,7997,0,0,7997,0
2251,A,7999,7999,0,0,0,0,7999,0
2251,C,7995,1,7994,0,0,0,7994,1
2252,T,7985,1,4,0,0,7980,7980,5
2252,T,7999,0,0,0,0,7998,7998,1
2253,C,7995,1,7984,0,0,0,7984,11
2253,G,7999,0,0,7994,0,0,7994,5
2254,C,7994,0,7992,0,0,1,7992,2
2254,T,7993,0,0,0,0,7993,7993,0
2255,C,7987,0,7986,0,0,1,7986,1
2255,G,7996,1,2,7992,0,0,7992,4
2256,A,7979,7971,1,0,0,0,7971,8
2256,C,7999,0,7585,1,0,1,7585,414
2257,A,7982,7979,2,1,0,0,7979,3
2257,C,7992,1,7989,1,0,1,7989,3
2258,C,7993,0,7991,0,0,2,7991,2
2258,C,7995,0,7994,0,0,1,7994,1
2259,C,7995,0,7995,0,0,0,7995,0
2259,G,7994,1,0,7993,0,0,7993,1
2260,C,7990,0,7989,0,0,0,7989,1
2260,C,7997,0,7994,1,0,2,7994,3
2261,C,7999,1,7998,0,0,0,7998,1
2261,G,7990,1,0,7988,0,1,7988,2
2262,T,7987,0,0,0,0,7986,7986,1
2262,T,7995,0,0,0,0,7995,7995,0
2263,A,7986,7985,0,1,0,0,7985,1
2263,G,7999,0,0,7997,0,0,7997,2
2264,A,7999,7999,0,0,0,0,7999,0
2264,T,7993,0,0,0,0,7993,7993,0
2265,A,7994,7994,0,0,0,0,7994,0
2265,C,7998,0,7998,0,0,0,7998,0
2266,G,8000,0,0,7998,0,0,7998,2
2266,T,7993,0,0,0,0,7992,7992,1
2267,A,7992,7991,0,1,0,0,7991,1
2267,C,7984,1,7982,0,0,1,7982,2
2268,G,7996,2,0,7994,0,0,7994,2
2268,T,7961,0,2,0,0,7959,7959,2
2269,C,7985,0,7983,0,0,1,7983,2
2269,G,7982,1,0,7971,0,1,7971,11
2270,A,7979,7977,0,0,0,0,7977,2
2270,G,7984,0,0,7984,0,0,7984,0
2271,C,7992,0,7973,0,0,0,7973,19
2271,T,7987,0,0,0,0,7987,7987,0
2272,C,7988,0,7988,0,0,0,7988,0
2272,C,7992,0,7992,0,0,0,7992,0
2273,A,7988,7988,0,0,0,0,7988,0
2273,C,7969,0,7969,0,0,0,7969,0
2274,C,7993,0,7992,0,0,0,7992,1
2274,G,7992,0,0,7990,0,1,7990,2
2275,A,7992,7861,0,2,0,0,7861,131
2275,T,7992,0,0,0,0,7992,7992,0
2276,A,7991,7991,0,0,0,0,7991,0
2276,A,7993,7992,1,0,0,0,7992,1
2277,A,7992,7992,0,0,0,0,7992,0
2277,C,7994,0,7994,0,0,0,7994,0
2278,A,7969,7966,1,1,0,1,7966,3
2278,A,7994,7994,0,0,0,0,7994,0
2279,A,7994,7994,0,0,0,0,7994,0
2279,T,7995,0,1,0,0,7994,7994,1
2280,C,7988,0,7988,0,0,0,7988,0
2280,T,7994,0,0,0,0,7994,7994,0
2281,C,7991,0,7991,0,0,0,7991,0
2281,G,7991,0,0,7991,0,0,7991,0
2282,C,7991,1,7988,0,0,0,7988,3
2282,G,7990,1,0,7989,0,0,7989,1
2283,A,7996,7996,0,0,0,0,7996,0
2283,G,7983,1,0,7982,0,0,7982,1
2284,A,7990,7985,0,0,0,0,7985,5
2284,C,7996,0,7994,0,0,0,7994,2
2285,A,7990,7990,0,0,0,0,7990,0
2285,G,7999,0,0,7999,0,0,7999,0
2286,C,8000,1,7999,0,0,0,7999,1
2286,G,7991,0,0,7991,0,0,7991,0
2287,C,7991,0,7990,0,0,1,7990,1
2287,T,8000,0,0,0,0,8000,8000,0
2288,A,7979,7979,0,0,0,0,7979,0
2288,C,8001,0,8001,0,0,0,8001,0
2289,A,8001,7997,0,1,0,0,7997,4
2289,G,7995,1,0,7994,0,0,7994,1
2290,A,8002,8002,0,0,0,0,8002,0
2290,C,7994,0,7993,0,0,0,7993,1
2291,G,7995,1,0,7994,0,0,7994,1
2291,G,8003,0,0,8003,0,0,8003,0
2292,C,7996,0,7994,0,0,0,7994,2
2292,T,8003,0,0,0,0,8003,8003,0
2293,A,7993,7928,0,0,0,1,7928,65
2293,C,8002,0,8002,0,0,0,8002,0
2294,A,7993,7992,0,0,0,1,7992,1
2294,A,7994,7994,0,0,0,0,7994,0
2295,A,7995,7993,0,2,0,0,7993,2
2295,G,7999,0,0,7997,0,1,7997,2
2296,A,7996,7994,1,0,0,0,7994,2
2296,A,7998,7998,0,0,0,0,7998,0
2297,C,7996,1,7992,1,0,0,7992,4
2297,G,7994,0,0,7988,0,0,7988,6
2298,G,7991,2,1,7986,0,0,7986,5
2298,G,7995,0,0,7995,0,0,7995,0
2299,C,7994,1,7986,1,0,1,7986,8
2299,T,7975,0,0,0,0,7975,7975,0
2300,C,7994,1,7993,0,0,0,7993,1
2300,G,7984,0,0,7982,0,1,7982,2
2301,G,7984,2,0,7982,0,0,7982,2
2301,T,7993,0,0,0,0,7993,7993,0
2302,A,7995,7985,0,0,0,0,7985,10
2302,C,7982,0,7980,0,0,1,7980,2
2303,A,7996,7994,0,2,0,0,7994,2
2303,G,7982,0,0,7982,0,0,7982,0
2304,A,7986,7972,0,1,0,0,7972,14
2304,C,7997,0,7966,0,0,0,7966,31
2305,A,7986,7985,0,1,0,0,7985,1
2305,C,7998,0,7998,0,0,0,7998,0
2306,A,7992,7992,0,0,0,0,7992,0
2306,C,7996,0,7996,0,0,0,7996,0
2307,C,7998,1,7975,0,0,0,7975,23
2307,T,7979,0,0,0,0,7978,7978,1
2308,A,7995,7993,0,0,0,0,7993,2
2308,C,7997,0,7997,0,0,0,7997,0
2309,A,7996,7995,0,1,0,0,7995,1
2309,C,7997,0,7997,0,0,0,7997,0
2310,G,7997,2,1,7994,0,0,7994,3
2310,G,7999,0,0,7998,0,0,7998,1
2311,A,7999,7997,0,1,0,0,7997,2
2311,C,7998,0,7998,0,0,0,7998,0
2312,A,7960,7959,0,0,0,0,7959,1
2312,C,8000,0,7999,0,0,1,7999,1
2313,A,7999,7997,0,0,0,0,7997,2
2313,G,7968,1,0,7966,0,0,7966,2
2314,A,7968,7967,0,1,0,0,7967,1
2314,G,7998,0,0,7984,0,1,7984,14
2315,G,7999,0,0,7998,0,0,7998,1
2315,T,7972,0,0,0,0,7967,7967,5
2316,A,7995,7995,0,0,0,0,7995,0
2316,T,7975,0,0,0,0,7974,7974,1
2317,C,7991,0,7990,0,0,0,7990,1
2317,C,7998,0,7996,0,0,2,7996,2
2318,T,7987,0,1,1,0,7985,7985,2
2318,T,7992,1,0,0,0,7988,7988,4
2319,A,7998,7995,0,0,0,1,7995,3
2319,T,7993,0,0,0,0,7993,7993,0
2320,C,7993,0,7992,0,0,0,7992,1
2320,T,7999,1,0,0,0,7997,7997,2
2321,A,7994,7991,0,3,0,0,7991,3
2321,A,7999,7990,0,0,0,0,7990,9
2322,A,8000,8000,0,0,0,0,8000,0
2322,T,7993,1,0,1,0,7990,7990,3
2323,A,7964,7962,0,2,0,0,7962,2
2323,G,7994,1,0,7993,0,0,7993,1
2324,C,7993,0,7991,0,0,2,7991,2
2324,G,7971,0,0,7971,0,0,7971,0
2325,A,7956,7954,0,0,0,1,7954,2
2325,A,7992,7989,0,0,0,0,7989,3
2326,A,7994,7993,0,1,0,0,7993,1
2326,T,7937,0,0,0,0,7937,7937,0
2327,A,7939,7939,0,0,0,0,7939,0
2327,T,7993,2,0,0,0,7985,7985,8
2328,C,7938,1,7931,0,0,0,7931,7
2328,T,7993,0,1,0,0,7992,7992,1
2329,C,7911,0,7910,0,0,1,7910,1
2329,G,7993,0,0,7993,0,0,7993,0
2330,A,7907,7904,1,0,0,0,7904,3
2330,T,7990,0,1,0,0,7989,7989,1
2331,C,7990,0,7990,0,0,0,7990,0
2331,G,7909,0,0,7904,0,0,7904,5
2332,G,7922,0,0,7921,0,0,7921,1
2332,G,7995,1,0,7981,0,1,7981,14
2333,C,7919,0,7918,0,0,0,7918,1
2333,G,7995,0,0,7995,0,0,7995,0
2334,G,7918,0,0,7915,0,0,7915,3
2334,T,7995,0,0,0,0,7993,7993,2
2335,C,7990,0,7990,0,0,0,7990,0
2335,T,7908,0,0,0,0,7891,7891,17
2336,A,7990,7984,1,0,0,1,7984,6
2336,T,7904,0,0,0,0,7904,7904,0
2337,A,7994,7993,1,0,0,0,7993,1
2337,T,7908,0,1,0,0,7901,7901,7
2338,C,7910,0,7510,0,0,7,7510,400
2338,G,7995,0,0,7995,0,0,7995,0
2339,C,7939,0,7938,0,0,0,7938,1
2339,C,7995,0,7986,0,0,1,7986,9
2340,C,7958,0,7958,0,0,0,7958,0
2340,C,7995,1,7993,0,0,0,7993,2
2341,C,7965,0,7965,0,0,0,7965,0
2341,T,7991,0,1,0,0,7984,7984,7
2342,C,7967,0,7967,0,0,0,7967,0
2342,T,7992,0,1,0,0,7991,7991,1
2343,G,7995,0,0,7995,0,0,7995,0
2343,T,7966,0,2,0,0,7964,7964,2
2344,C,7996,0,7984,0,0,1,7984,12
2344,G,7973,0,0,7966,0,1,7966,7
2345,C,7997,1,7994,0,0,2,7994,3
2345,G,7974,0,0,7974,0,0,7974,0
2346,A,7979,7974,1,0,0,0,7974,5
2346,T,7988,0,0,0,0,7985,7985,3
2347,A,7979,7979,0,0,0,0,7979,0
2347,T,7993,0,0,1,0,7992,7992,1
2348,G,7978,1,0,7976,0,1,7976,2
2348,G,7994,0,0,7994,0,0,7994,0
2349,C,7972,0,7970,0,0,2,7970,2
2349,T,7995,0,0,0,0,7988,7988,7
2350,T,7975,0,0,0,0,7974,7974,1
2350,T,7996,0,0,0,0,7996,7996,0
2351,C,7988,0,7939,0,0,0,7939,49
2351,G,7996,1,0,7995,0,0,7995,1
2352,C,7989,1,7988,0,0,0,7988,1
2352,T,7992,1,0,0,0,7991,7991,1
2353,A,7993,7993,0,0,0,0,7993,0
2353,C,7998,0,7998,0,0,0,7998,0
2354,G,7995,1,0,7994,0,0,7994,1
2354,T,7997,0,0,0,0,7997,7997,0
2355,C,7995,0,7994,0,0,1,7994,1
2355,C,7997,0,7996,0,0,0,7996,1
2356,G,7998,0,0,7997,0,0,7997,1
2356,T,7994,0,0,0,0,7993,7993,1
2357,T,7981,0,1,0,0,7979,7979,2
2357,T,7995,0,0,0,0,7995,7995,0
2358,A,7978,7960,0,2,0,0,7960,18
2358,G,7998,0,0,7998,0,0,7998,0
2359,A,7986,7986,0,0,0,0,7986,0
2359,C,7995,0,7994,0,0,0,7994,1
2360,A,7986,7983,1,0,0,1,7983,3
2360,G,7992,2,0,7988,0,1,7988,4
2361,C,7998,0,7997,0,0,1,7997,1
2361,T,7986,1,0,1,0,7885,7885,101
2362,T,7985,0,0,0,0,7985,7985,0
2362,T,7986,0,0,0,0,7986,7986,0
2363,C,7998,1,7996,0,0,1,7996,2
2363,T,7985,0,0,0,0,7985,7985,0
2364,T,7987,0,0,1,0,7985,7985,2
2364,T,7997,0,1,0,0,7996,7996,1
2365,C,7998,0,7995,0,0,0,7995,3
2365,G,7994,0,0,7994,0,0,7994,0
2366,C,7996,1,7992,0,0,3,7992,4
2366,C,7999,0,7996,0,0,2,7996,3
2367,T,7995,0,3,1,0,15986,15986,-7991
2368,C,7995,0,7993,0,0,1,7993,2
2368,G,7998,0,0,7998,0,0,7998,0
2369,G,7996,2,0,7994,0,0,7994,2
2369,T,7997,0,0,0,0,7993,7993,4
2370,C,7997,0,7997,0,0,0,7997,0
2370,T,7995,0,0,0,0,7995,7995,0
2371,C,7995,0,7985,0,0,2,7985,10
2371,G,7998,4,0,7993,0,0,7993,5
2372,C,7918,1,7917,0,0,0,7917,1
2372,C,7999,0,7997,0,0,2,7997,2
2373,A,7999,7995,0,0,0,0,7995,4
2373,G,7919,3,0,7916,0,0,7916,3
2374,A,7923,7923,0,0,0,0,7923,0
2374,C,7998,0,7995,0,0,2,7995,3
2375,C,7931,0,7923,0,0,0,7923,8
2375,T,7999,0,0,0,0,7998,7998,1
2376,A,8001,8001,0,0,0,0,8001,0
2376,C,7928,0,7928,0,0,0,7928,0
2377,C,7926,0,7925,0,0,1,7925,1
2377,C,8003,0,8001,0,0,0,8001,2
2378,T,7926,0,0,0,0,7925,7925,1
2378,T,7990,0,1,0,0,7989,7989,1
2379,C,7994,0,7992,0,0,2,7992,2
2379,G,7940,1,0,7939,0,0,7939,1
2380,A,7987,7987,0,0,0,0,7987,0
2380,C,7940,0,7930,0,0,3,7930,10
2381,C,7940,0,7940,0,0,0,7940,0
2381,G,7995,1,0,7992,0,0,7992,3
2382,C,7994,0,7991,0,0,1,7991,3
2382,G,7950,0,0,7950,0,0,7950,0
2383,C,7949,0,7949,0,0,0,7949,0
2383,G,7968,2,0,7966,0,0,7966,2
2384,A,7985,7982,0,3,0,0,7982,3
2384,T,7950,0,0,0,0,7947,7947,3
2385,C,7976,0,7968,0,0,0,7968,8
2385,T,7951,0,0,0,0,7951,7951,0
2386,A,7970,7969,0,0,0,0,7969,1
2386,C,7992,0,7992,0,0,0,7992,0
2387,C,7999,0,7993,0,0,0,7993,6
2387,T,7992,1,0,0,0,7991,7991,1
2388,C,7995,0,7995,0,0,0,7995,0
2388,C,7996,1,7993,2,0,0,7993,3
2389,C,7996,1,7995,0,0,0,7995,1
2389,G,7997,0,2,7989,0,0,7989,8
2390,A,7996,7985,0,0,0,0,7985,11
2390,G,7999,0,0,7999,0,0,7999,0
2391,A,7997,7989,1,0,0,0,7989,8
2391,A,7999,7999,0,0,0,0,7999,0
2392,C,7991,1,7989,0,0,0,7989,2
2392,T,8000,0,1,0,0,7999,7999,1
2393,A,7995,7994,0,0,0,0,7994,1
2393,A,8000,7997,0,1,0,0,7997,3
2394,C,7996,0,7996,0,0,0,7996,0
2394,C,8000,1,7994,0,0,1,7994,6
2395,A,7991,7988,0,0,0,1,7988,3
2395,C,8000,1,7997,0,0,2,7997,3
2396,C,7995,0,7995,0,0,0,7995,0
2396,T,7980,1,2,0,0,7977,7977,3
2397,A,7991,7983,0,0,0,1,7983,8
2397,G,7987,0,0,7985,0,0,7985,2
2398,A,7995,7993,1,1,0,0,7993,2
2398,T,7982,0,0,0,0,7981,7981,1
2399,C,7983,0,7971,0,0,1,7971,12
2399,G,7996,2,0,7994,0,0,7994,2
2400,C,7981,0,7980,0,0,0,7980,1
2400,C,7992,0,7992,0,0,0,7992,0
2401,A,7980,7978,0,1,0,0,7978,2
2401,G,7985,2,0,7983,0,0,7983,2
2402,C,7999,0,7997,0,0,1,7997,2
2402,G,7995,0,0,7937,0,2,7937,58
2403,C,7996,0,7994,0,0,2,7994,2
2403,G,7984,1,0,7983,0,0,7983,1
2404,G,7995,0,0,7994,0,0,7994,1
2404,T,7998,0,1,0,0,7979,7979,19
2405,A,7991,7990,0,0,0,0,7990,1
2405,T,7999,0,0,0,0,7999,7999,0
2406,G,7995,0,0,7995,0,0,7995,0
2406,T,7999,0,2,0,0,7997,7997,2
2407,C,7996,1,7994,0,0,1,7994,2
2407,C,8000,0,8000,0,0,0,8000,0
2408,A,7986,7983,1,1,0,0,7983,3
2408,T,7999,1,2,0,0,7996,7996,3
2409,C,8000,2,7944,0,0,1,7944,56
2409,G,7994,1,0,7992,0,1,7992,2
2410,A,7995,7993,2,0,0,0,7993,2
2410,C,8001,1,8000,0,0,0,8000,1
2411,C,7984,0,7981,0,0,3,7981,3
2411,T,7994,0,0,1,0,7991,7991,3
2412,A,7993,7993,0,0,0,0,7993,0
2412,T,7987,0,1,0,0,7983,7983,4
2413,C,7989,0,7988,0,0,0,7988,1
2413,T,7988,0,1,0,0,7987,7987,1
2414,C,7994,0,7992,0,0,2,7992,2
2414,T,7978,0,1,1,0,7974,7974,4
2415,G,7994,0,1,15906,0,0,15906,-7912
2416,G,7995,1,0,15988,0,1,15988,-7993
2417,C,7996,0,7995,0,0,1,7995,1
2417,G,7996,0,0,7995,0,1,7995,1
2418,A,7989,7982,0,1,0,1,7982,7
2418,T,7986,0,0,0,0,7980,7980,6
2419,A,7986,7984,0,2,0,0,7984,2
2419,T,7990,0,0,0,0,7990,7990,0
2420,A,7995,7994,0,0,0,0,7994,1
2420,G,7999,2,0,7997,0,0,7997,2
2421,A,7996,7996,0,0,0,0,7996,0
2421,C,7998,0,7995,1,0,2,7995,3
2422,C,7997,0,7997,0,0,0,7997,0
2422,G,7999,1,1,7995,0,0,7995,4
2423,T,7990,1,2,0,0,7986,7986,4
2423,T,7995,0,1,0,0,7992,7992,3
2424,A,7983,7982,0,0,0,1,7982,1
2424,G,7993,1,1,7983,0,0,7983,10
2425,G,7996,0,0,7996,0,0,7996,0
2425,T,7969,1,0,0,0,7967,7967,2
2426,C,7996,0,7996,0,0,0,7996,0
2426,G,7969,0,0,7967,0,0,7967,2
2427,C,7976,0,7976,0,0,0,7976,0
2427,G,7997,1,0,7995,0,1,7995,2
2428,C,7998,0,7998,0,0,0,7998,0
2428,G,7970,1,0,7963,0,2,7963,7
2429,G,7980,0,0,7979,0,0,7979,1
2429,T,7993,1,1,0,0,7983,7983,10
2430,C,7985,0,7984,0,0,1,7984,1
2430,T,7998,0,0,0,0,7997,7997,1
2431,A,7986,7985,0,1,0,0,7985,1
2431,T,7998,0,1,0,0,7997,7997,1
2432,C,7999,0,7999,0,0,0,7999,0
2432,T,7994,0,2,0,0,7991,7991,3
2433,C,7994,1,7993,0,0,0,7993,1
2433,T,8001,1,1,0,0,7998,7998,3
2434,A,7992,7991,0,1,0,0,7991,1
2434,C,7999,0,7999,0,0,0,7999,0
2435,A,7999,7996,0,0,0,0,7996,3
2435,G,7995,0,0,7994,0,1,7994,1
2436,A,7992,7991,0,0,0,0,7991,1
2436,T,8000,0,0,0,0,8000,8000,0
2437,A,8000,7999,0,0,0,0,7999,1
2437,G,7995,0,0,7994,0,0,7994,1
2438,C,7990,0,7989,0,0,1,7989,1
2438,G,8001,1,0,8000,0,0,8000,1
2439,A,7987,7986,0,1,0,0,7986,1
2439,C,7995,0,7995,0,0,0,7995,0
2440,G,7995,3,0,7992,0,0,7992,3
2440,T,7992,0,1,0,0,7991,7991,1
2441,A,7993,7993,0,0,0,0,7993,0
2441,C,7970,0,7970,0,0,0,7970,0
2442,A,7975,7974,0,0,0,0,7974,1
2442,T,7995,0,0,0,0,7990,7990,5
2443,C,7998,0,7997,0,0,1,7997,1
2443,T,7996,0,0,0,0,7996,7996,0
2444,G,7984,0,0,7983,0,0,7983,1
2444,G,7998,1,0,7997,0,0,7997,1
2445,C,7999,1,7998,0,0,0,7998,1
2445,T,7995,0,0,0,0,7994,7994,1
2446,A,7995,7994,0,0,0,1,7994,1
2446,T,7993,0,1,1,0,7991,7991,2
2447,C,7996,1,7993,0,0,1,7993,3
2447,G,7998,3,0,7995,0,0,7995,3
2448,T,7972,0,0,0,0,7972,7972,0
2448,T,7996,0,0,1,0,7995,7995,1
2449,A,7999,7998,0,1,0,0,7998,1
2449,G,7995,0,0,7994,0,0,7994,1
2450,A,7986,7985,0,0,0,0,7985,1
2450,G,7997,0,0,7992,0,1,7992,5
2451,G,7995,0,0,15989,0,1,15989,-7994
2452,A,7991,7989,0,1,0,0,7989,2
2452,T,7972,0,0,0,0,7972,7972,0
2453,A,7972,7970,0,0,0,0,7970,2
2453,G,7976,0,0,7976,0,0,7976,0
2454,T,7956,0,0,0,0,7955,7955,1
2454,T,7981,0,2,0,0,7979,7979,2
2455,C,7983,0,7982,0,0,1,7982,1
2455,G,7994,3,1,7990,0,0,7990,4
2456,C,7995,0,7992,1,0,2,7992,3
2456,T,7969,0,0,0,0,7969,7969,0
2457,A,7996,7994,1,0,0,0,7994,2
2457,C,7977,0,7977,0,0,0,7977,0
2458,A,7965,7965,0,0,0,0,7965,0
2458,C,7997,0,7979,0,0,0,7979,18
2459,C,7991,0,7991,0,0,0,7991,0
2459,G,7999,0,0,7999,0,0,7999,0
2460,A,7989,7987,1,0,0,0,7987,2
2460,T,7994,0,0,0,0,7991,7991,3
2461,T,7991,1,0,0,0,7990,7990,1
2461,T,7998,0,1,0,0,7997,7997,1
2462,A,7985,7982,0,2,0,1,7982,3
2462,C,7998,0,7998,0,0,0,7998,0
2463,G,7992,1,0,7983,0,0,7983,9
2463,G,7995,2,0,7923,0,1,7923,72
2464,G,7985,0,0,7984,0,0,7984,1
2464,G,7999,0,0,7999,0,0,7999,0
2465,G,7981,0,0,7980,0,0,7980,1
2465,T,7998,0,0,2,0,7995,7995,3
2466,G,7991,3,0,7987,0,1,7987,4
2466,G,7998,1,0,7997,0,0,7997,1
2467,A,7939,7937,0,1,0,1,7937,2
2467,T,7996,1,1,0,0,7994,7994,2
2468,A,7980,7979,0,0,0,1,7979,1
2468,T,7945,0,0,1,0,7944,7944,1
2469,C,7942,0,7940,0,0,2,7940,2
2469,G,7986,1,0,7979,0,1,7979,7
2470,G,7945,0,1,7901,0,1,7901,44
2470,G,7989,0,0,7989,0,0,7989,0
2471,G,7995,0,0,7994,0,0,7994,1
2471,T,7989,0,0,0,0,7989,7989,0
2472,C,7973,0,7972,0,0,1,7972,1
2472,G,7995,0,0,7995,0,0,7995,0
2473,A,7978,7977,0,1,0,0,7977,1
2473,G,7949,2,1,7944,0,1,7944,5
2474,G,7979,0,0,7978,0,0,7978,1
2474,T,7946,0,0,0,0,7941,7941,5
2475,A,7977,7974,0,2,0,1,7974,3
2475,T,7946,0,0,0,0,7946,7946,0
2476,C,7944,0,7943,1,0,0,7943,1
2476,T,7982,1,0,0,0,7981,7981,1
2477,C,7994,0,7993,0,0,0,7993,1
2477,G,7976,1,1,7973,0,1,7973,3
2478,C,7999,0,7998,0,0,0,7998,1
2478,T,7992,0,0,0,0,7992,7992,0
2479,C,7994,0,7970,0,0,0,7970,24
2479,T,7999,0,0,0,0,7999,7999,0
2480,C,7991,1,7990,0,0,0,7990,1
2480,C,8000,1,7995,0,0,0,7995,5
2481,C,7982,0,7980,0,0,2,7980,2
2481,C,7997,0,7997,0,0,0,7997,0
2482,A,7999,7992,0,0,0,1,7992,7
2482,G,7981,1,0,7978,0,0,7978,3
2483,A,7980,7979,0,0,0,0,7979,1
2483,A,7999,7999,0,0,0,0,7999,0
2484,G,8000,0,0,7999,0,1,7999,1
2484,T,7981,0,0,0,0,7981,7981,0
2485,C,7983,0,7979,0,0,2,7979,4
2485,C,8000,0,7998,0,0,1,7998,2
2486,C,7975,0,7975,0,0,0,7975,0
2486,T,7990,0,1,1,0,7988,7988,2
2487,G,7991,0,0,7966,0,0,7966,25
2487,G,8000,0,0,8000,0,0,8000,0
2488,G,7997,0,0,7997,0,0,7997,0
2488,T,7996,0,0,0,0,7996,7996,0
2489,C,7996,0,7995,0,0,1,7995,1
2489,G,7999,1,1,7997,0,0,7997,2
2490,C,8000,0,7998,0,0,2,7998,2
2490,G,8000,1,0,7999,0,0,7999,1
2491,A,8001,8000,0,0,0,0,8000,1
2491,T,7972,0,1,0,0,7970,7970,2
2492,C,8001,0,8000,0,0,0,8000,1
2492,G,7998,1,1,7996,0,0,7996,2
2493,G,7999,1,0,7991,0,0,7991,8
2493,T,7990,0,0,0,0,7990,7990,0
2494,G,7999,0,0,7999,0,0,7999,0
2494,T,8000,1,6,0,0,7993,7993,7
2495,C,8001,0,8001,0,0,0,8001,0
2495,T,8000,0,0,2,0,7996,7996,4
2496,A,7999,7998,0,0,0,0,7998,1
2496,G,7999,2,0,7996,0,0,7996,3
2497,C,7999,0,7998,1,0,0,7998,1
2497,G,8000,0,0,7994,0,0,7994,6
2498,A,8000,8000,0,0,0,0,8000,0
2498,G,8001,1,0,8000,0,0,8000,1
2499,C,8001,0,7999,0,0,2,7999,2
2499,T,8001,0,0,0,0,8001,8001,0
2500,G,7995,0,0,7989,0,0,7989,6
2500,G,8001,0,0,8001,0,0,8001,0
2501,A,7977,7967,0,1,0,0,7967,10
2501,G,7997,3,0,7994,0,0,7994,3
2502,A,7975,7972,1,1,0,0,7972,3
2502,C,7997,0,7995,0,0,2,7995,2
2503,A,7997,7997,0,0,0,0,7997,0
2503,C,7995,2,7680,0,0,0,7680,315
2504,C,7982,1,7980,0,0,1,7980,2
2504,C,7999,0,7999,0,0,0,7999,0
2505,C,7983,2,7981,0,0,0,7981,2
2505,T,7998,0,1,0,0,7954,7954,44
2506,C,7981,0,7980,0,0,0,7980,1
2506,T,7999,0,0,0,0,7999,7999,0
2507,C,7981,0,7981,0,0,0,7981,0
2507,T,8000,0,0,0,0,8000,8000,0
2508,C,7997,1,7993,1,0,2,7993,4
2508,T,8001,0,1,0,0,8000,8000,1
2509,C,8002,0,7997,1,0,4,7997,5
2509,G,7998,2,0,7996,0,0,7996,2
2510,G,8003,0,1,7882,0,1,7882,121
2510,T,7997,0,0,0,0,7991,7991,6
2511,G,8004,0,0,8004,0,0,8004,0
2511,T,7997,0,0,1,0,7996,7996,1
2512,C,7997,1,7993,0,0,2,7993,4
2512,G,8005,0,0,8005,0,0,8005,0
2513,A,7982,7982,0,0,0,0,7982,0
2513,G,8004,0,0,8001,0,0,8001,3
2514,A,8002,7980,0,1,0,0,7980,22
2514,G,7994,0,0,7994,0,0,7994,0
2515,A,8003,8003,0,0,0,0,8003,0
2515,C,7997,0,7945,0,0,0,7945,52
2516,A,8004,8004,0,0,0,0,8004,0
2516,C,7996,1,7995,0,0,0,7995,1
2517,C,7989,1,7987,0,0,1,7987,2
2517,T,8004,0,0,1,0,8003,8003,1
2518,G,7982,0,1,7981,0,0,7981,1
2518,G,8004,1,0,8002,0,0,8002,2
2519,A,7982,7977,0,2,0,0,7977,5
2519,T,8002,0,0,0,0,8001,8001,1
2520,C,7998,0,7993,0,0,0,7993,5
2520,G,8003,0,0,7999,0,1,7999,4
2521,C,7998,0,7997,1,0,0,7997,1
2521,C,8004,0,8002,1,0,0,8002,2
2522,G,7999,1,0,7995,0,0,7995,4
2522,G,8003,0,1,8002,0,0,8002,1
2523,C,7999,1,7995,0,0,1,7995,4
2523,C,8004,0,8002,0,0,1,8002,2
2524,G,8003,1,0,8000,0,0,8000,3
2524,T,7999,0,1,0,0,7998,7998,1
2525,G,8000,3,0,7995,0,1,7995,5
2525,G,8004,1,0,8003,0,0,8003,1
2526,A,8005,7989,0,1,0,0,7989,16
2526,C,8001,0,7999,0,0,1,7999,2
2527,A,8005,8002,1,0,0,0,8002,3
2527,G,8001,1,0,7999,0,1,7999,2
2528,C,8002,0,7993,1,0,1,7993,9
2528,C,8005,3,7921,0,0,1,7921,84
2529,C,8001,0,8001,0,0,0,8001,0
2529,C,8008,2,8006,0,0,0,8006,2
2530,C,8009,0,8009,0,0,0,8009,0
2530,T,8000,0,0,0,0,7996,7996,4
2531,C,8010,0,8010,0,0,0,8010,0
2531,T,8000,1,0,0,0,7999,7999,1
2532,A,8001,8001,0,0,0,0,8001,0
2532,T,8008,0,0,0,0,8004,8004,4
2533,A,8008,8007,0,1,0,0,8007,1
2533,T,8002,0,0,0,0,8002,8002,0
2534,C,8002,0,7995,0,0,1,7995,7
2534,T,8005,0,0,0,0,7996,7996,9
2535,C,8000,0,8000,0,0,0,8000,0
2535,T,8005,1,0,0,0,8004,8004,1
2536,G,7988,1,0,7977,0,0,7977,11
2536,T,7999,0,0,2,0,7997,7997,2
2537,G,7994,0,0,7993,0,1,7993,1
2537,G,7999,0,0,7994,0,4,7994,5
2538,T,7988,0,0,1,0,7971,7971,17
2538,T,7993,0,0,0,0,7993,7993,0
2539,A,7995,7993,0,1,0,0,7993,2
2539,T,7988,0,0,0,0,7988,7988,0
2540,A,7995,7993,0,1,0,1,7993,2
2540,T,7988,1,0,1,0,7986,7986,2
2541,A,7990,7987,0,1,0,0,7987,3
2541,C,7989,0,7988,0,0,0,7988,1
2542,T,7988,2,0,0,0,15893,15893,-7905
2543,A,7999,7997,0,0,0,1,7997,2
2543,T,7986,0,0,0,0,7986,7986,0
2544,T,7998,1,0,0,0,15995,15995,-7997
2545,C,7992,0,7992,0,0,0,7992,0
2545,T,7998,0,0,0,0,7998,7998,0
2546,G,7998,0,1,7997,0,0,7997,1
2546,T,7997,0,1,0,0,7996,7996,1
2547,C,7997,0,7996,0,0,0,7996,1
2547,T,7998,0,0,1,0,7996,7996,2
2548,C,7999,0,7999,0,0,0,7999,0
2548,T,7998,0,0,0,0,7997,7997,1
2549,A,7999,7990,0,0,0,0,7990,9
2549,T,7997,0,0,0,0,7994,7994,3
2550,A,7997,7997,0,0,0,0,7997,0
2550,T,7987,0,2,0,0,7985,7985,2
2551,A,7997,7997,0,0,0,0,7997,0
2551,G,7994,0,0,7994,0,0,7994,0
2552,A,7994,7991,0,1,0,1,7991,3
2552,T,8000,0,1,0,0,7999,7999,1
2553,A,7999,7997,0,0,0,2,7997,2
2553,G,7999,0,0,7998,0,0,7998,1
2554,C,8000,2,7997,0,0,0,7997,3
2554,T,7998,1,0,0,0,7997,7997,1
2555,A,7995,7995,0,0,0,0,7995,0
2555,C,7990,0,7985,0,0,0,7985,5
2556,C,7987,0,7987,0,0,0,7987,0
2556,T,8000,0,1,0,0,7998,7998,2
2557,A,7986,7982,1,0,0,0,7982,4
2557,T,8001,0,0,0,0,8001,8001,0
2558,A,7998,7997,0,1,0,0,7997,1
2558,C,8002,0,8002,0,0,0,8002,0
2559,A,8002,7987,0,0,0,0,7987,15
2559,C,7999,0,7942,0,0,0,7942,57
2560,A,8001,8000,0,0,0,1,8000,1
2560,C,7998,0,7998,0,0,0,7998,0
2561,A,8003,8001,0,0,0,1,8001,2
2561,C,7996,1,7995,0,0,0,7995,1
2562,G,7992,1,0,7983,0,1,7983,9
2562,T,8002,0,2,0,0,8000,8000,2
2563,A,8000,7998,0,0,0,0,7998,2
2563,G,7999,0,0,7999,0,0,7999,0
2564,T,7997,0,2,0,0,7994,7994,3
2564,T,7999,2,0,0,0,7997,7997,2
2565,A,7997,7996,0,0,0,0,7996,1
2565,G,7994,3,0,7991,0,0,7991,3
2566,A,7997,7997,0,0,0,0,7997,0
2566,T,7993,0,0,0,0,7993,7993,0
2567,A,7993,7992,0,1,0,0,7992,1
2567,G,7996,1,0,7995,0,0,7995,1
2568,A,7996,7993,0,1,0,0,7993,3
2568,T,7993,0,0,0,0,7993,7993,0
2569,C,7995,0,7995,0,0,0,7995,0
2569,C,7998,1,7992,0,0,1,7992,6
2570,A,7982,7980,1,0,0,0,7980,2
2570,C,7987,2,7984,1,0,0,7984,3
2571,C,7991,0,7987,1,0,1,7987,4
2571,G,8000,3,0,7995,0,1,7995,5
2572,C,8000,0,8000,0,0,0,8000,0
2572,G,7990,0,0,7989,0,0,7989,1
2573,A,7998,7998,0,0,0,0,7998,0
2573,T,8001,0,0,0,0,8001,8001,0
2574,C,7998,0,7995,0,0,2,7995,3
2574,C,7999,0,7999,0,0,0,7999,0
2575,A,7996,7996,0,0,0,0,7996,0
2575,T,7990,0,1,0,0,7988,7988,2
2576,T,7985,0,1,0,0,7984,7984,1
2576,T,7999,1,0,0,0,7998,7998,1
2577,A,7987,7986,0,0,0,0,7986,1
2577,G,7999,0,0,7999,0,0,7999,0
2578,A,7999,7999,0,0,0,0,7999,0
2578,T,7990,0,0,0,0,7989,7989,1
2579,C,7991,0,7989,0,0,1,7989,2
2579,G,8000,2,0,7997,0,0,7997,3
2580,A,7991,7991,0,0,0,0,7991,0
2580,G,7987,1,0,7986,0,0,7986,1
2581,C,7998,0,7990,0,0,0,7990,8
2581,C,7999,0,7999,0,0,0,7999,0
2582,A,8000,7997,0,1,0,0,7997,3
2582,C,7987,0,7984,0,0,2,7984,3
2583,A,7986,7984,0,0,0,0,7984,2
2583,A,7998,7997,0,0,0,1,7997,1
2584,C,7987,0,7985,0,0,1,7985,2
2584,T,7999,0,1,0,0,7998,7998,1
2585,A,7999,7997,0,1,0,0,7997,2
2585,T,7987,0,0,0,0,7987,7987,0
2586,A,8000,8000,0,0,0,0,8000,0
2586,G,7998,0,0,7980,0,0,7980,18
2587,C,8001,2,7975,0,0,1,7975,26
2587,G,7999,3,1,7995,0,0,7995,4
2588,C,7995,0,7993,0,0,2,7993,2
2588,C,8000,0,7999,1,0,0,7999,1
2589,A,7999,7998,1,0,0,0,7998,1
2589,C,7996,0,7995,0,0,1,7995,1
2590,G,7998,0,0,7997,0,1,7997,1
2590,T,7981,0,1,0,0,7980,7980,1
2591,C,7999,0,7997,0,0,2,7997,2
2591,G,8000,2,0,7998,0,0,7998,2
2592,A,7999,7998,0,0,0,0,7998,1
2592,A,8001,8000,0,0,0,1,8000,1
2593,G,8000,1,0,7999,0,0,7999,1
2593,T,8002,0,0,0,0,8001,8001,1
2594,A,8002,7991,0,0,0,0,7991,11
2594,C,8001,0,7996,0,0,1,7996,5
2595,A,7991,7991,0,0,0,0,7991,0
2595,C,7999,0,7999,0,0,0,7999,0
2596,A,7991,7988,1,1,0,1,7988,3
2596,A,7999,7999,0,0,0,0,7999,0
2597,C,7998,1,7996,0,0,0,7996,2
2597,T,7993,1,0,0,0,7991,7991,2
2598,G,7997,0,0,7997,0,0,7997,0
2598,T,7998,1,1,0,0,7996,7996,2
2599,C,8000,0,7999,0,0,1,7999,1
2599,G,7999,2,0,7993,0,1,7993,6
2600,G,7999,0,0,7996,0,3,7996,3
2600,T,7983,0,0,0,0,7982,7982,1
2601,T,7984,0,0,0,0,7984,7984,0
2601,T,7999,0,0,1,0,7998,7998,1
2602,A,7994,7989,0,0,0,0,7989,5
2602,C,8000,0,8000,0,0,0,8000,0
2603,A,7995,7993,1,1,0,0,7993,2
2603,A,7999,7992,0,1,0,0,7992,7
2604,A,8000,8000,0,0,0,0,8000,0
2604,C,7998,0,7997,0,0,1,7997,1
2605,A,7995,7995,0,0,0,0,7995,0
2605,T,8000,0,1,0,0,7999,7999,1
2606,A,7998,7991,0,0,0,0,7991,7
2606,G,7996,0,0,7984,0,0,7984,12
2607,A,7999,7999,0,0,0,0,7999,0
2607,G,7997,0,0,7997,0,0,7997,0
2608,A,7987,7986,0,0,0,1,7986,1
2608,T,7996,1,0,0,0,7995,7995,1
2609,A,7999,7996,0,0,0,2,7996,3
2609,T,7983,0,0,0,0,7982,7982,1
2610,T,7989,0,0,0,0,7989,7989,0
2610,T,7999,1,0,0,0,7987,7987,12
2611,A,7992,7990,0,1,0,1,7990,2
2611,T,7996,1,1,0,0,7994,7994,2
2612,G,7997,1,0,7996,0,0,7996,1
2612,G,8000,0,0,7999,0,1,7999,1
2613,A,7997,7945,0,0,0,0,7945,52
2613,C,7998,0,7998,0,0,0,7998,0
2614,A,7987,7987,0,0,0,0,7987,0
2614,A,8000,8000,0,0,0,0,8000,0
2615,A,8000,8000,0,0,0,0,8000,0
2615,G,7997,0,0,7997,0,0,7997,0
2616,A,7972,7972,0,0,0,0,7972,0
2616,A,7999,7999,0,0,0,0,7999,0
2617,A,8000,7996,0,3,0,1,7996,4
2617,G,7978,1,0,7977,0,0,7977,1
2618,C,7980,0,7979,1,0,0,7979,1
2618,G,8000,1,0,7993,0,0,7993,7
2619,G,7998,1,1,7995,0,1,7995,3
2619,G,8001,0,0,8001,0,0,8001,0
2620,A,7998,7997,0,1,0,0,7997,1
2620,A,8000,7997,0,0,0,1,7997,3
2621,A,7999,7999,0,0,0,0,7999,0
2621,G,7998,0,0,7996,0,0,7996,2
2622,G,7999,0,0,7999,0,0,7999,0
2622,G,8000,0,0,7999,0,1,7999,1
2623,A,7998,7998,0,0,0,0,7998,0
2623,T,8001,1,1,0,0,7999,7999,2
2624,A,7996,7995,0,1,0,0,7995,1
2624,G,8000,0,0,8000,0,0,8000,0
2625,T,7997,0,0,1,0,7996,7996,1
2625,T,8001,0,1,0,0,7999,7999,2
2626,A,8002,8002,0,0,0,0,8002,0
2626,G,7999,1,0,7998,0,0,7998,1
2627,T,7998,0,0,0,0,7998,7998,0
2627,T,8001,0,0,2,0,7995,7995,6
2628,A,7984,7984,0,0,0,0,7984,0
2628,G,8002,0,0,8000,0,0,8000,2
2629,A,8002,8000,0,1,0,0,8000,2
2629,G,7979,0,0,7970,0,1,7970,9
2630,G,7972,0,1,7971,0,0,7971,1
2630,G,8004,0,0,8002,0,0,8002,2
2631,C,7917,0,7914,0,0,1,7914,3
2631,T,7967,0,1,0,0,7966,7966,1
2632,A,7976,7976,0,0,0,0,7976,0
2632,G,7915,0,0,7909,0,0,7909,6
2633,G,7996,0,0,7996,0,0,7996,0
2633,T,7961,0,0,0,0,7958,7958,3
2634,T,7960,0,0,0,0,7960,7960,0
2634,T,7993,0,1,0,0,7992,7992,1
2635,C,7992,0,7990,0,0,0,7990,2
2635,G,7999,0,0,7999,0,0,7999,0
2636,A,7986,7980,0,1,0,0,7980,6
2636,C,7999,0,7999,0,0,0,7999,0
2637,A,8000,8000,0,0,0,0,8000,0
2637,T,8000,0,0,0,0,8000,8000,0
2638,A,8001,8001,0,0,0,0,8001,0
2638,C,8000,0,7999,0,0,1,7999,1
2639,A,7984,7984,0,0,0,0,7984,0
2639,C,8001,0,8001,0,0,0,8001,0
2640,A,8002,8002,0,0,0,0,8002,0
2640,T,8000,1,2,0,0,7980,7980,20
2641,G,8003,0,0,8003,0,0,8003,0
2641,T,7999,0,0,0,0,7999,7999,0
2642,A,7941,7941,0,0,0,0,7941,0
2642,T,8000,0,2,0,0,7998,7998,2
2643,C,8001,0,7992,0,0,1,7992,9
2643,G,7999,0,0,7998,0,0,7998,1
2644,C,7999,0,7999,0,0,0,7999,0
2644,T,7981,0,1,0,0,7978,7978,3
2645,G,8000,1,0,7997,0,0,7997,3
2645,T,7985,0,0,0,0,7985,7985,0
2646,C,7998,0,7998,0,0,0,7998,0
2646,T,7998,0,1,0,0,7997,7997,1
2647,G,7997,0,0,7997,0,0,7997,0
2647,T,7994,1,3,0,0,7986,7986,8
2648,T,7994,0,1,0,0,7992,7992,2
2648,T,7999,0,0,0,0,7999,7999,0
2649,C,7995,0,7995,0,0,0,7995,0
2649,G,7996,0,0,7996,0,0,7996,0
2650,A,7996,7990,0,0,0,0,7990,6
2650,G,7998,0,0,7998,0,0,7998,0
2651,A,7997,7997,0,0,0,0,7997,0
2651,C,8000,0,7966,0,0,0,7966,34
2652,C,8000,1,7999,0,0,0,7999,1
2652,G,7997,0,0,7997,0,0,7997,0
2653,C,8001,0,8000,0,0,1,8000,1
2653,T,7967,0,0,0,0,7967,7967,0
2654,G,7966,0,0,7964,0,0,7964,2
2654,T,8002,0,0,0,0,7999,7999,3
2655,G,7966,2,0,7964,0,0,7964,2
2655,T,8002,0,0,0,0,8002,8002,0
2656,A,8003,8002,0,0,0,1,8002,1
2656,T,7964,0,0,1,0,7960,7960,4
2657,G,7996,0,0,7978,0,0,7978,18
2657,T,8003,1,0,0,0,8001,8001,2
2658,G,7999,1,0,7998,0,0,7998,1
2658,T,8003,0,1,0,0,8002,8002,1
2659,C,8000,0,7995,0,0,3,7995,5
2659,C,8004,0,7947,0,0,0,7947,57
2660,C,7992,1,7991,0,0,0,7991,1
2660,C,8001,0,8001,0,0,0,8001,0
2661,C,7996,4,7979,0,0,6,7979,17
2661,T,7997,0,0,0,0,7997,7997,0
2662,A,7999,7996,0,0,0,0,7996,3
2662,T,7985,0,5,0,0,7827,7827,158
2663,A,7999,7999,0,0,0,0,7999,0
2663,T,7993,0,1,0,0,7992,7992,1
2664,C,8000,0,7999,0,0,0,7999,1
2664,T,7995,0,0,0,0,7995,7995,0
2665,T,7993,0,0,0,0,7993,7993,0
2665,T,8000,1,0,0,0,7998,7998,2
2666,A,7992,7990,0,0,0,0,7990,2
2666,T,7996,1,0,0,0,7995,7995,1
2667,C,7993,0,7991,0,0,2,7991,2
2667,T,7996,0,0,1,0,7995,7995,1
2668,G,7996,0,1,15984,0,2,15984,-7988
2669,C,7996,0,7995,0,0,1,7995,1
2669,G,7998,0,0,7998,0,0,7998,0
2670,C,7999,0,7999,0,0,0,7999,0
2670,G,7995,0,0,7988,0,0,7988,7
2671,G,7999,0,0,7999,0,0,7999,0
2671,T,7990,0,0,0,0,7990,7990,0
2672,A,7996,7995,0,1,0,0,7995,1
2672,C,7999,0,7999,0,0,0,7999,0
2673,A,8000,7998,0,1,0,0,7998,2
2673,C,7998,0,7997,0,0,1,7997,1
2674,A,7998,7996,0,0,0,0,7996,2
2674,T,8000,0,0,0,0,7944,7944,56
2675,C,7999,0,7999,0,0,0,7999,0
2675,T,7999,0,1,0,0,7998,7998,1
2676,T,7993,0,0,0,0,7993,7993,0
2676,T,8000,0,1,0,0,7999,7999,1
2677,A,7987,7985,0,1,0,1,7985,2
2677,T,8000,0,0,0,0,8000,8000,0
2678,G,7998,0,1,7995,0,1,7995,3
2678,G,8000,0,0,7998,0,1,7998,2
2679,A,7999,7997,0,0,0,0,7997,2
2679,C,8000,0,7995,0,0,2,7995,5
2680,A,7999,7996,0,2,0,0,7996,3
2680,C,8001,0,8001,0,0,0,8001,0
2681,G,7997,3,0,7994,0,0,7994,3
2681,T,7999,1,2,0,0,7994,7994,5
2682,A,7978,7971,0,1,0,0,7971,7
2682,T,7999,0,0,0,0,7999,7999,0
2683,A,7992,7992,0,0,0,0,7992,0
2683,C,8000,0,7989,0,0,0,7989,11
2684,C,7999,0,7999,0,0,0,7999,0
2684,C,8001,0,8001,0,0,0,8001,0
2685,A,7990,7989,0,0,0,1,7989,1
2685,T,8000,0,0,0,0,7999,7999,1
2686,G,7999,0,0,7996,0,2,7996,3
2686,G,8001,1,0,8000,0,0,8000,1
2687,T,7991,0,0,0,0,7991,7991,0
2687,T,8001,0,0,0,0,7914,7914,87
2688,A,7999,7998,0,1,0,0,7998,1
2688,T,8000,0,0,0,0,8000,8000,0
2689,T,8000,0,0,0,0,7993,7993,7
2689,T,8001,0,0,0,0,8001,8001,0
2690,T,7994,0,0,0,0,7994,7994,0
2690,T,8000,0,0,0,0,8000,8000,0
2691,T,7999,0,1,1,0,7997,7997,2
2691,T,8000,0,0,0,0,8000,8000,0
2692,G,7998,1,0,7989,0,1,7989,9
2692,G,8000,2,0,7998,0,0,7998,2
2693,C,8001,0,8001,0,0,0,8001,0
2693,G,7997,0,0,7996,0,1,7996,1
2694,T,7994,0,0,0,0,7994,7994,0
2694,T,8000,0,0,0,0,8000,8000,0
2695,A,7956,7956,0,0,0,0,7956,0
2695,C,7996,0,7996,0,0,0,7996,0
2696,A,7998,7997,0,1,0,0,7997,1
2696,T,7952,0,0,0,0,7952,7952,0
2697,C,7948,0,7947,0,0,1,7947,1
2697,C,8000,0,7984,0,0,0,7984,16
2698,C,8001,0,8001,0,0,0,8001,0
2698,T,7944,1,1,1,0,7941,7941,3
2699,C,8002,0,8002,0,0,0,8002,0
2699,G,7970,1,0,7967,0,1,7967,3
2700,A,8002,8001,0,0,0,1,8001,1
2700,C,7970,0,7968,0,0,2,7968,2
2701,G,7987,0,0,7987,0,0,7987,0
2701,G,8002,0,0,8001,0,0,8001,1
2702,A,8003,7980,0,1,0,0,7980,23
2702,C,7988,0,7987,0,0,0,7987,1
2703,A,8003,8002,1,0,0,0,8002,1
2703,T,7981,0,0,0,0,7980,7980,1
2704,A,8004,8004,0,0,0,0,8004,0
2704,C,7999,0,7997,0,0,1,7997,2
2705,C,8002,0,7999,0,0,2,7999,3
2705,T,7997,0,0,0,0,7997,7997,0
2706,G,7986,0,0,7986,0,0,7986,0
2706,G,7999,0,0,7999,0,0,7999,0
2707,C,7986,0,7985,0,0,0,7985,1
2707,C,8000,2,7997,0,0,0,7997,3
2708,T,7984,0,0,0,0,7982,7982,2
2708,T,7991,0,1,0,0,7990,7990,1
2709,G,7991,0,0,7991,0,0,7991,0
2709,G,8000,1,0,7994,0,0,7994,6
2710,A,7991,7989,0,1,0,1,7989,2
2710,G,8001,0,0,8001,0,0,8001,0
2711,A,7999,7999,0,0,0,0,7999,0
2711,T,8000,0,0,0,0,7999,7999,1
2712,G,8000,0,0,8000,0,0,8000,0
2712,G,8001,0,0,8001,0,0,8001,0
2713,A,8000,7992,0,1,0,0,7992,8
2713,C,7988,0,7976,0,0,0,7976,12
2714,A,8001,8000,0,1,0,0,8000,1
2714,C,7994,0,7993,0,0,1,7993,1
2715,A,7979,7978,0,0,0,1,7978,1
2715,A,8002,8002,0,0,0,0,8002,0
2716,G,7981,1,2,7976,0,2,7976,5
2716,G,8002,0,0,8001,0,0,8001,1
2717,T,7981,0,1,1,0,7975,7975,6
2717,T,8003,0,0,0,0,8001,8001,2
2718,A,8000,7975,0,0,0,0,7975,25
2718,T,7981,0,1,0,0,7980,7980,1
2719,A,7982,7981,0,0,0,0,7981,1
2719,A,7999,7998,0,1,0,0,7998,1
2720,A,8001,8000,0,0,0,0,8000,1
2720,C,7985,0,7984,0,0,0,7984,1
2721,A,8001,7996,1,4,0,0,7996,5
2721,C,7985,0,7985,0,0,0,7985,0
2722,G,8001,0,0,8001,0,0,8001,0
2722,T,7981,1,0,1,0,7978,7978,3
2723,A,7996,7992,1,1,0,1,7992,4
2723,T,7982,0,0,0,0,7982,7982,0
2724,C,7985,0,7984,0,0,1,7984,1
2724,T,7996,0,0,0,0,7995,7995,1
2725,G,7983,1,0,7960,0,1,7960,23
2725,G,7998,2,0,7996,0,0,7996,2
2726,C,8000,1,7998,0,0,1,7998,2
2726,G,7996,0,0,7995,0,1,7995,1
2727,A,7996,7872,0,1,0,0,7872,124
2727,T,7997,0,1,1,0,7995,7995,2
2728,A,7995,7995,0,0,0,0,7995,0
2728,G,8000,0,0,8000,0,0,8000,0
2729,A,7995,7994,0,1,0,0,7994,1
2729,A,7999,7996,0,2,0,0,7996,3
2730,A,7996,7995,0,0,0,1,7995,1
2730,A,7999,7999,0,0,0,0,7999,0
2731,A,7999,7995,1,3,0,0,7995,4
2731,G,8000,0,0,8000,0,0,8000,0
2732,A,7995,7994,0,0,0,0,7994,1
2732,G,8000,0,0,7999,0,0,7999,1
2733,A,8000,8000,0,0,0,0,8000,0
2733,T,8000,0,0,0,0,8000,8000,0
2734,C,7999,0,7996,0,0,3,7996,3
2734,G,8001,0,0,8000,0,0,8000,1
2735,A,7991,7990,0,0,0,0,7990,1
2735,T,7998,1,0,1,0,7988,7988,10
2736,G,8000,0,0,7999,0,1,7999,1
2736,T,7999,0,0,0,0,7999,7999,0
2737,G,8000,0,0,7994,0,0,7994,6
2737,T,7996,0,0,0,0,7986,7986,10
2738,G,8001,2,0,7999,0,0,7999,2
2738,T,7997,0,1,0,0,7996,7996,1
2739,G,7998,1,0,7981,0,1,7981,17
2739,T,8001,0,0,0,0,8001,8001,0
2740,A,8001,8000,0,1,0,0,8000,1
2740,G,7986,1,0,7985,0,0,7985,1
2741,G,7999,1,0,7998,0,0,7998,1
2741,G,8000,0,0,8000,0,0,8000,0
2742,C,7998,0,7997,0,0,0,7997,1
2742,T,7997,0,1,0,0,7995,7995,2
2743,G,7998,0,0,7998,0,0,7998,0
2743,T,7993,0,0,0,0,7991,7991,2
2744,C,7996,1,7995,0,0,0,7995,1
2744,C,7999,1,7997,0,0,1,7997,2
2745,A,7996,7995,0,1,0,0,7995,1
2745,T,7995,0,1,1,0,7989,7989,6
2746,C,8000,0,7999,0,0,1,7999,1
2746,T,7995,0,0,0,0,7995,7995,0
2747,G,7996,0,0,7995,0,0,7995,1
2747,G,8001,0,0,8000,0,0,8000,1
2748,A,7995,7993,0,1,0,1,7993,2
2748,A,7999,7997,1,0,0,1,7997,2
2749,G,8000,0,0,7999,0,0,7999,1
2749,T,7995,1,0,0,0,7994,7994,1
2750,C,7996,0,7992,0,0,1,7992,4
2750,T,7979,0,0,0,0,7979,7979,0
2751,C,7980,1,7977,0,0,2,7977,3
2751,G,8000,0,0,7988,0,0,7988,12
2752,G,7982,1,0,7976,0,1,7976,6
2752,G,7999,0,0,7999,0,0,7999,0
2753,G,7985,1,1,7983,0,0,7983,2
2753,G,7997,0,0,7997,0,0,7997,0
2754,C,7985,1,7984,0,0,0,7984,1
2754,T,7996,0,0,0,0,7983,7983,13
2755,A,7997,7979,0,0,0,0,7979,18
2755,T,7989,0,3,0,0,7986,7986,3
2756,A,7997,7997,0,0,0,0,7997,0
2756,A,8000,7999,0,1,0,0,7999,1
2757,A,7999,7998,0,0,0,1,7998,1
2757,C,8000,0,8000,0,0,0,8000,0
2758,A,7999,7998,0,0,0,0,7998,1
2758,C,8000,0,8000,0,0,0,8000,0
2759,A,8000,7980,0,0,0,0,7980,20
2759,T,7999,1,0,0,0,7998,7998,1
2760,A,8001,8001,0,0,0,0,8001,0
2760,C,7978,1,7976,0,0,1,7976,2
2761,A,7999,7997,0,1,0,0,7997,2
2761,G,7996,2,0,7993,0,1,7993,3
2762,A,8000,7996,0,0,0,0,7996,4
2762,C,7999,0,7988,0,0,1,7988,11
2763,A,8001,8001,0,0,0,0,8001,0
2763,C,8001,1,7999,0,0,1,7999,2
2764,A,7996,7996,0,0,0,0,7996,0
2764,C,8002,0,8001,0,0,0,8001,1
2765,C,7999,1,7987,0,0,0,7987,12
2765,T,7996,0,0,1,0,7995,7995,1
2766,C,8000,0,7999,0,0,1,7999,1
2766,G,7998,1,0,7994,0,0,7994,4
2767,G,8000,0,0,8000,0,0,8000,0
2767,G,8001,1,0,7999,0,1,7999,2
2768,A,8001,8001,0,0,0,0,8001,0
2768,C,8000,0,7998,1,0,0,7998,2
2769,T,7996,0,0,0,0,7995,7995,1
2769,T,8002,0,0,0,0,8001,8001,1
2770,C,7994,1,7993,0,0,0,7993,1
2770,G,7998,1,0,7986,0,0,7986,12
2771,G,7999,1,0,7998,0,0,7998,1
2771,T,7991,1,1,0,0,7989,7989,2
2772,C,8000,1,7999,0,0,0,7999,1
2772,T,7999,0,0,2,0,7996,7996,3
2773,A,7998,7998,0,0,0,0,7998,0
2773,A,7999,7989,2,2,0,0,7989,10
2774,A,8000,8000,0,0,0,0,8000,0
2774,G,7997,1,0,7994,0,0,7994,3
2775,C,7994,0,7993,0,0,0,7993,1
2775,C,8001,0,7998,0,0,3,7998,3
2776,A,7988,7985,1,0,0,1,7985,3
2776,G,7993,1,0,7988,0,0,7988,5
2777,G,7994,0,0,7994,0,0,7994,0
2777,G,8000,0,0,7999,0,1,7999,1
2778,C,7999,1,7996,0,0,1,7996,3
2778,T,7992,1,0,0,0,7989,7989,3
2779,G,7998,2,0,15970,0,1,15970,-7972
2780,G,7999,0,0,15991,0,4,15991,-7992
2781,T,7996,0,1,3,0,7764,7764,232
2781,T,7998,0,0,0,0,7998,7998,0
2782,A,7999,7998,0,0,0,0,7998,1
2782,T,7997,0,1,0,0,7996,7996,1
2783,A,7999,7997,1,0,0,1,7997,2
2783,T,8001,0,0,0,0,8001,8001,0
2784,G,7999,0,0,7998,0,0,7998,1
2784,T,8001,0,0,0,0,8001,8001,0
2785,A,7998,7997,0,0,0,0,7997,1
2785,T,8001,1,2,0,0,7998,7998,3
2786,T,7995,0,0,0,0,7993,7993,2
2786,T,8001,0,0,0,0,8001,8001,0
2787,C,7998,0,7993,0,0,0,7993,5
2787,T,8002,0,0,3,0,7999,7999,3
2788,C,7996,0,7996,0,0,0,7996,0
2788,G,8003,0,1,7996,0,6,7996,7
2789,T,7994,0,0,0,0,7984,7984,10
2789,T,7997,0,0,3,0,7971,7971,26
2790,T,7993,1,1,0,0,7991,7991,2
2790,T,7995,0,0,0,0,7995,7995,0
2791,G,7993,0,0,7991,0,0,7991,2
2791,T,7995,0,1,0,0,7994,7994,1
2792,A,7991,7989,0,1,0,1,7989,2
2792,G,7997,1,0,7996,0,0,7996,1
2793,C,7998,0,7998,0,0,0,7998,0
2793,G,7994,0,0,7994,0,0,7994,0
2794,A,7989,7988,0,0,0,0,7988,1
2794,A,7999,7992,0,0,0,1,7992,7
2795,A,8000,8000,0,0,0,0,8000,0
2795,G,7999,0,0,7999,0,0,7999,0
2796,G,8000,2,0,7997,0,0,7997,3
2796,T,7994,0,0,1,0,7950,7950,44
2797,C,8001,0,8000,0,0,1,8000,1
2797,T,7992,0,0,0,0,7992,7992,0
2798,A,8000,7997,0,1,0,2,7997,3
2798,T,7993,0,1,1,0,7991,7991,2
2799,G,8001,2,0,7999,0,0,7999,2
2799,T,7992,0,2,0,0,7990,7990,2
2800,C,7992,0,7990,0,0,1,7990,2
2800,C,8002,0,8001,0,0,1,8001,1
2801,A,8003,8001,0,1,0,1,8001,2
2801,G,7999,0,1,7998,0,0,7998,1
2802,C,8000,0,7897,2,0,0,7897,103
2802,G,8004,0,0,8004,0,0,8004,0
2803,A,8005,8005,0,0,0,0,8005,0
2803,C,7998,0,7998,0,0,0,7998,0
2804,C,8001,0,8001,0,0,0,8001,0
2804,T,8005,1,1,1,0,7993,7993,12
2805,C,8002,0,8002,0,0,0,8002,0
2805,T,8003,0,1,0,0,8002,8002,1
2806,A,8001,7999,0,0,0,0,7999,2
2806,G,8003,0,0,8002,0,0,8002,1
2807,A,8004,8001,0,0,0,1,8001,3
2807,C,8001,0,7998,0,0,3,7998,3
2808,A,8004,8003,0,1,0,0,8003,1
2808,G,8000,2,0,7997,0,0,7997,3
2809,C,8000,1,7999,0,0,0,7999,1
2809,G,8005,0,0,8005,0,0,8005,0
2810,A,8004,8001,0,0,0,0,8001,3
2810,G,7999,4,0,7994,0,1,7994,5
2811,A,8005,8005,0,0,0,0,8005,0
2811,C,8000,0,8000,0,0,0,8000,0
2812,A,7987,7985,0,2,0,0,7985,2
2812,C,8006,0,8004,1,0,1,8004,2
2813,G,7999,1,0,7998,0,0,7998,1
2813,G,8005,1,0,8003,0,1,8003,2
2814,A,8000,7773,0,0,0,0,7773,227
2814,T,8006,0,3,0,0,7964,7964,42
2815,A,8000,8000,0,0,0,0,8000,0
2815,T,8004,0,0,0,0,8004,8004,0
2816,A,8002,8002,0,0,0,0,8002,0
2816,T,8005,0,0,0,0,8005,8005,0
2817,A,8002,8002,0,0,0,0,8002,0
2817,T,8006,0,2,0,0,8003,8003,3
2818,A,8002,8002,0,0,0,0,8002,0
2818,C,8006,0,7999,0,0,1,7999,7
2819,A,8003,8003,0,0,0,0,8003,0
2819,C,8007,0,8007,0,0,0,8007,0
2820,A,8003,7999,0,4,0,0,7999,4
2820,A,8007,8003,0,0,0,0,8003,4
2821,A,8008,8006,1,1,0,0,8006,2
2821,G,8003,2,0,7994,0,1,7994,9
2822,G,8002,0,0,8002,0,0,8002,0
2822,T,8005,0,0,0,0,8005,8005,0
2823,A,7997,7997,0,0,0,0,7997,0
2823,G,8006,2,0,8004,0,0,8004,2
2824,A,8006,8006,0,0,0,0,8006,0
2824,T,7999,1,0,0,0,7998,7998,1
2825,C,8000,0,7998,0,0,1,7998,2
2825,T,8000,1,0,0,0,7998,7998,2
2826,G,8001,0,0,8000,0,0,8000,1
2826,T,7999,0,2,0,0,7997,7997,2
2827,A,7996,7995,0,1,0,0,7995,1
2827,C,8000,0,7999,0,0,1,7999,1
2828,A,8000,7990,1,0,0,0,7990,10
2828,G,7999,2,0,7997,0,0,7997,2
2829,A,8000,7999,0,1,0,0,7999,1
2829,C,8000,0,7999,0,0,1,7999,1
2830,A,8000,7999,0,0,0,0,7999,1
2830,G,8002,0,0,8002,0,0,8002,0
2831,A,8003,7997,0,0,0,0,7997,6
2831,C,8001,0,8000,0,0,1,8000,1
2832,A,8001,8001,0,0,0,0,8001,0
2832,T,7994,0,3,0,0,7942,7942,52
2833,G,7998,0,0,7998,0,0,7998,0
2833,T,7997,0,0,0,0,7997,7997,0
2834,A,7996,7995,0,0,0,0,7995,1
2834,T,7999,0,0,0,0,7999,7999,0
2835,T,7998,0,0,0,0,7998,7998,0
2835,T,8000,1,0,0,0,7999,7999,1
2836,A,8000,7987,0,0,0,0,7987,13
2836,C,7995,0,7990,0,0,0,7990,5
2837,A,8001,8001,0,0,0,0,8001,0
2837,C,7996,0,7996,0,0,0,7996,0
2838,A,8001,8000,0,0,0,0,8000,1
2838,T,7996,0,2,0,0,7984,7984,12
2839,G,8001,0,0,8001,0,0,8001,0
2839,T,7997,0,1,0,0,7996,7996,1
2840,T,7979,1,0,0,0,7973,7973,6
2840,T,7998,1,0,0,0,7997,7997,1
2841,G,7999,1,0,7998,0,0,7998,1
2841,T,7979,0,0,0,0,7979,7979,0
2842,A,7999,7998,0,1,0,0,7998,1
2842,C,7997,0,7995,0,0,1,7995,2
2843,T,7998,0,1,0,0,15994,15994,-7996
2844,C,7998,0,7998,0,0,0,7998,0
2844,G,8000,0,0,8000,0,0,8000,0
2845,C,8001,0,8000,0,0,0,8000,1
2845,T,7980,0,2,0,0,7943,7943,37
2846,T,7998,0,0,1,0,7997,7997,1
2846,T,7999,1,0,0,0,7998,7998,1
2847,A,8000,7998,0,1,0,1,7998,2
2847,T,7999,0,0,0,0,7999,7999,0
2848,T,7996,1,1,0,0,7994,7994,2
2848,T,8001,0,0,0,0,8001,8001,0
2849,C,8002,0,8000,0,0,1,8000,2
2849,G,8000,0,0,8000,0,0,8000,0
2850,T,7998,1,0,1,0,7996,7996,2
2850,T,8001,0,0,0,0,8001,8001,0
2851,A,7998,7995,1,1,0,0,7995,3
2851,G,7978,1,0,7972,0,0,7972,6
2852,C,7998,1,7991,0,0,5,7991,7
2852,G,8000,2,0,7997,0,1,7997,3
2853,C,7994,1,7992,0,0,0,7992,2
2853,G,7996,0,1,7960,0,3,7960,36
2854,G,7994,0,0,7993,0,0,7993,1
2854,G,7999,0,0,7999,0,0,7999,0
2855,C,7999,0,7997,0,0,0,7997,2
2855,G,7992,0,0,7992,0,0,7992,0
2856,G,7999,1,0,15992,0,1,15992,-7993
2857,G,8000,1,1,7998,0,0,7998,2
2857,T,7998,0,1,0,0,7997,7997,1
2858,C,7998,2,7995,0,0,1,7995,3
2858,T,7998,0,0,0,0,7998,7998,0
2859,A,8000,8000,0,0,0,0,8000,0
2859,T,7998,0,0,1,0,7997,7997,1
2860,G,7999,2,0,7997,0,0,7997,2
2860,T,8000,0,1,0,0,7995,7995,5
2861,A,8000,7999,0,0,0,0,7999,1
2861,T,7996,0,1,0,0,7995,7995,1
2862,A,7999,7999,0,0,0,0,7999,0
2862,C,8001,0,8001,0,0,0,8001,0
2863,G,7996,1,1,7994,0,0,7994,2
2863,T,8000,0,0,1,0,7999,7999,1
2864,C,7995,0,7994,0,0,1,7994,1
2864,C,8001,0,7965,0,0,1,7965,36
2865,C,8000,0,7998,0,0,1,7998,2
2865,T,7976,0,1,0,0,7975,7975,1
2866,C,7912,0,7911,1,0,0,7911,1
2866,C,7997,0,7997,0,0,0,7997,0
2867,A,7991,7991,0,0,0,0,7991,0
2867,G,7956,1,0,7954,0,0,7954,2
2868,G,7999,0,0,7999,0,0,7999,0
2868,T,7999,0,0,0,0,7998,7998,1
2869,A,7999,7999,0,0,0,0,7999,0
2869,T,7997,0,0,0,0,7997,7997,0
2870,G,7998,1,0,7987,0,0,7987,11
2870,T,7999,2,0,0,0,7994,7994,5
2871,G,7999,0,0,7998,0,1,7998,1
2871,T,7993,0,2,0,0,7991,7991,2
2872,A,7997,7994,0,0,0,0,7994,3
2872,G,7993,0,0,7993,0,0,7993,0
2873,A,7992,7992,0,0,0,0,7992,0
2873,A,7998,7998,0,0,0,0,7998,0
2874,C,7997,1,7993,1,0,2,7993,4
2874,C,7998,0,7998,0,0,0,7998,0
2875,G,7993,0,0,7993,0,0,7993,0
2875,G,7995,1,1,7989,0,2,7989,6
2876,A,7991,7942,0,0,0,0,7942,49
2876,C,7995,0,7990,0,0,0,7990,5
2877,A,7979,7979,0,0,0,0,7979,0
2877,C,7989,1,7984,1,0,0,7984,5
2878,A,7981,7980,0,1,0,0,7980,1
2878,G,7996,0,0,7970,0,0,7970,26
2879,A,7986,7986,0,0,0,0,7986,0
2879,G,8000,0,0,8000,0,0,8000,0
2880,C,7987,0,7986,0,0,1,7986,1
2880,G,8000,0,0,8000,0,0,8000,0
2881,C,8001,0,8000,0,0,0,8000,1
2881,T,7985,0,0,0,0,7985,7985,0
2882,A,8000,7995,1,1,0,0,7995,5
2882,C,7993,0,7993,0,0,0,7993,0
2883,A,7992,7991,1,0,0,0,7991,1
2883,A,8000,7997,0,1,0,1,7997,3
2884,C,7999,0,7998,0,0,1,7998,1
2884,G,8000,1,0,7999,0,0,7999,1
2885,A,8001,8001,0,0,0,0,8001,0
2885,G,8000,0,0,8000,0,0,8000,0
2886,G,8001,1,0,8000,0,0,8000,1
2886,T,8001,0,0,0,0,7999,7999,2
2887,C,7998,0,7998,0,0,0,7998,0
2887,T,8000,1,0,0,0,7999,7999,1
2888,A,7994,7987,0,3,0,0,7987,7
2888,A,8001,7995,0,0,0,0,7995,6
2889,A,7995,7993,0,1,0,0,7993,2
2889,A,8001,8001,0,0,0,0,8001,0
2890,C,7997,0,7997,0,0,0,7997,0
2890,G,8002,1,0,7946,0,0,7946,56
2891,G,8001,1,0,8000,0,0,8000,1
2891,T,7999,0,0,1,0,7998,7998,1
2892,C,7997,0,7997,0,0,0,7997,0
2892,G,8002,2,0,7999,0,0,7999,3
2893,A,7987,7985,0,1,0,0,7985,2
2893,G,7993,0,1,7986,0,1,7986,7
2894,G,7998,1,0,7997,0,0,7997,1
2894,T,7987,0,0,0,0,7950,7950,37
2895,T,7987,0,0,0,0,7987,7987,0
2895,T,7998,0,1,0,0,7996,7996,2
2896,C,7997,0,7997,0,0,0,7997,0
2896,T,7990,0,0,0,0,7990,7990,0
2897,G,8000,1,0,7998,0,0,7998,2
2897,T,7990,0,0,0,0,7990,7990,0
2898,C,8001,0,7998,0,0,1,7998,3
2898,G,7998,2,0,7990,0,1,7990,8
2899,C,8002,1,8001,0,0,0,8001,1
2899,G,7999,0,0,7999,0,0,7999,0
2900,G,8003,4,0,7999,0,0,7999,4
2900,T,7989,0,0,0,0,7989,7989,0
2901,C,7987,0,7986,0,0,0,7986,1
2901,C,8004,0,8003,0,0,1,8003,1
2902,A,7986,7985,0,1,0,0,7985,1
2902,A,8005,8002,1,0,0,0,8002,3
2903,T,7994,0,1,0,0,7993,7993,1
2903,T,8005,0,0,0,0,8005,8005,0
2904,A,8006,8005,1,0,0,0,8005,1
2904,G,7995,0,0,7995,0,0,7995,0
2905,A,7997,7995,0,1,0,1,7995,2
2905,C,8007,0,8007,0,0,0,8007,0
2906,A,8008,8008,0,0,0,0,8008,0
2906,G,7999,1,0,7997,0,1,7997,2
2907,A,7996,7996,0,0,0,0,7996,0
2907,C,8009,0,8007,0,0,1,8007,2
2908,T,7981,0,0,0,0,7981,7981,0
2908,T,7992,1,1,0,0,7984,7984,8
2909,A,7999,7998,0,0,0,0,7998,1
2909,T,7992,1,1,0,0,7990,7990,2
2910,A,7999,7998,0,0,0,1,7998,1
2910,T,7993,1,0,0,0,7987,7987,6
2911,T,7995,0,1,0,0,7994,7994,1
2911,T,8000,0,0,0,0,7999,7999,1
2912,C,7998,0,7997,0,0,1,7997,1
2912,C,8001,0,8001,0,0,0,8001,0
2913,A,7999,7906,0,0,0,0,7906,93
2913,T,7985,0,1,0,0,7983,7983,2
2914,A,7998,7998,0,0,0,0,7998,0
2914,C,7999,0,7997,0,0,1,7997,2
2915,A,7988,7987,0,1,0,0,7987,1
2915,A,7996,7996,0,0,0,0,7996,0
2916,A,7996,7996,0,0,0,0,7996,0
2916,G,7999,0,0,7998,0,1,7998,1
2917,A,7996,7995,0,0,0,1,7995,1
2917,A,7999,7997,0,1,0,0,7997,2
2918,A,7993,7992,0,1,0,0,7992,1
2918,G,7999,1,0,7993,0,0,7993,6
2919,G,7998,1,0,7996,0,1,7996,2
2919,T,7998,1,0,0,0,7996,7996,2
2920,A,7994,7993,0,0,0,0,7993,1
2920,G,7989,0,0,7989,0,0,7989,0
2921,A,7999,7997,0,1,0,0,7997,2
2921,T,7998,2,0,0,0,7996,7996,2
2922,C,7999,0,7999,0,0,0,7999,0
2922,C,8000,1,7999,0,0,0,7999,1
2923,T,7994,0,2,0,0,7992,7992,2
2923,T,8000,1,0,1,0,7996,7996,4
2924,T,7999,0,0,1,0,7998,7998,1
2924,T,8001,0,1,0,0,8000,8000,1
2925,C,8002,0,8001,0,0,1,8001,1
2925,G,7998,0,0,7987,0,1,7987,11
2926,A,8002,8001,1,0,0,0,8001,1
2926,G,7999,0,0,7999,0,0,7999,0
2927,C,8002,0,7998,0,0,0,7998,4
2927,T,8000,0,0,0,0,7994,7994,6
2928,C,7999,0,7999,0,0,0,7999,0
2928,T,8000,0,2,0,0,7998,7998,2
2929,G,8001,0,0,8001,0,0,8001,0
2929,T,7997,0,1,0,0,7995,7995,2
2930,A,7993,7992,0,1,0,0,7992,1
2930,A,7997,7997,0,0,0,0,7997,0
2931,G,7996,0,0,7996,0,0,7996,0
2931,G,7999,0,0,7998,0,0,7998,1
2932,A,7994,7994,0,0,0,0,7994,0
2932,T,7998,0,0,0,0,7998,7998,0
2933,A,7998,7998,0,0,0,0,7998,0
2933,T,7995,0,0,0,0,7995,7995,0
2934,C,7995,0,7991,0,0,0,7991,4
2934,C,7998,0,7994,0,0,4,7994,4
2935,C,7983,1,7979,0,0,2,7979,4
2935,T,7981,0,1,0,0,7980,7980,1
2936,C,7994,0,7994,0,0,0,7994,0
2936,T,7977,0,2,0,0,7956,7956,21
2937,A,7995,7995,0,0,0,0,7995,0
2937,T,7978,0,0,0,0,7978,7978,0
2938,C,7998,0,7991,0,0,0,7991,7
2938,T,7978,0,0,0,0,7978,7978,0
2939,C,7996,0,7996,0,0,0,7996,0
2939,T,7977,2,0,0,0,7974,7974,3
2940,A,7974,7947,0,0,0,1,7947,27
2940,A,7984,7980,0,1,0,2,7980,4
2941,A,7976,7975,0,1,0,0,7975,1
2941,G,7992,1,0,7990,0,0,7990,2
2942,A,7976,7974,0,0,0,2,7974,2
2942,T,7996,0,1,0,0,7995,7995,1
2943,C,7994,0,7992,0,0,0,7992,2
2943,T,7974,2,0,0,0,7962,7962,12
2944,A,7993,7991,0,1,0,0,7991,2
2944,T,7969,1,1,0,0,7966,7966,3
2945,A,7968,7888,0,0,0,3,7888,80
2945,C,7997,0,7997,0,0,0,7997,0
2946,A,7970,7970,0,0,0,0,7970,0
2946,A,7996,7996,0,0,0,0,7996,0
2947,A,7972,7971,0,0,0,1,7971,1
2947,G,7998,1,0,7997,0,0,7997,1
2948,A,7972,7972,0,0,0,0,7972,0
2948,A,7999,7968,0,0,0,0,7968,31
2949,A,7974,7974,0,0,0,0,7974,0
2949,A,7999,7999,0,0,0,0,7999,0
2950,A,7996,7995,0,1,0,0,7995,1
2950,T,7973,0,0,1,0,7970,7970,3
2951,A,7997,7995,0,2,0,0,7995,2
2951,G,7973,0,0,7972,0,0,7972,1
2952,A,7973,7967,0,0,0,1,7967,6
2952,G,7997,1,1,7995,0,0,7995,2
2953,A,7972,7971,0,1,0,0,7971,1
2953,C,7998,0,7998,0,0,0,7998,0
2954,A,7995,7995,0,0,0,0,7995,0
2954,G,7999,0,0,7999,0,0,7999,0
2955,T,7993,0,0,1,0,7945,7945,48
2955,T,7999,0,0,0,0,7998,7998,1
2956,C,7996,0,7995,0,0,0,7995,1
2956,T,7992,1,0,1,0,7990,7990,2
2957,T,7993,0,0,0,0,7993,7993,0
2957,T,7998,0,0,1,0,7988,7988,10
2958,T,7993,4,2,0,0,7987,7987,6
2958,T,7999,0,0,0,0,7999,7999,0
2959,A,7995,7980,0,1,0,2,7980,15
2959,A,8000,8000,0,0,0,0,8000,0
2960,A,7998,7998,0,0,0,0,7998,0
2960,C,8001,1,8000,0,0,0,8000,1
2961,A,7998,7997,0,0,0,1,7997,1
2961,G,7993,0,0,7992,0,0,7992,1
2962,G,8000,0,0,8000,0,0,8000,0
2962,T,7997,1,0,0,0,7996,7996,1
2963,A,7992,7992,0,0,0,0,7992,0
2963,C,7992,0,7988,0,0,4,7988,4
2964,A,7992,7983,0,1,0,0,7983,9
2964,T,7999,0,0,0,0,7997,7997,2
2965,A,7999,7999,0,0,0,0,7999,0
2965,G,7998,2,0,7984,0,0,7984,14
2966,G,8000,1,0,7999,0,0,7999,1
2966,T,8000,0,0,0,0,7999,7999,1
2967,C,8001,1,15999,0,0,1,15999,-7998
2968,A,8002,8002,0,0,0,0,8002,0
2968,T,8001,0,0,0,0,8001,8001,0
2969,A,8000,7992,0,0,0,0,7992,8
2969,T,8000,0,0,0,0,7999,7999,1
2970,A,8000,8000,0,0,0,0,8000,0
2970,G,8001,2,0,7999,0,0,7999,2
2971,A,8000,8000,0,0,0,0,8000,0
2971,A,8001,8000,0,1,0,0,8000,1
2972,C,8000,0,7998,0,0,2,7998,2
2972,G,8002,0,0,8001,0,0,8001,1
2973,A,7992,7991,0,0,0,1,7991,1
2973,T,7988,0,0,0,0,7984,7984,4
2974,A,7972,7971,0,0,0,1,7971,1
2974,G,8000,0,0,8000,0,0,8000,0
2975,T,7978,0,1,0,0,7976,7976,2
2975,T,7990,0,0,0,0,7990,7990,0
2976,A,7981,7978,0,1,0,0,7978,3
2976,A,7990,7983,0,0,0,0,7983,7
2977,A,7991,7987,0,2,0,0,7987,4
2977,T,7983,0,0,0,0,7982,7982,1
2978,A,7977,7976,0,1,0,0,7976,1
2978,G,7998,0,0,7998,0,0,7998,0
2979,A,7999,7998,0,0,0,0,7998,1
2979,T,7991,0,0,0,0,7989,7989,2
2980,G,7998,0,0,7997,0,1,7997,1
2980,G,7999,0,0,7999,0,0,7999,0
2981,A,7931,7930,0,0,0,1,7930,1
2981,A,7982,7980,0,1,0,0,7980,2
2982,A,8000,7999,0,1,0,0,7999,1
2982,G,7934,0,0,7932,0,1,7932,2
2983,T,7902,0,0,0,0,7901,7901,1
2983,T,7999,1,0,0,0,7992,7992,7
2984,A,7900,7886,0,0,0,1,7886,14
2984,T,7992,0,1,0,0,7991,7991,1
2985,A,7921,7921,0,0,0,0,7921,0
2985,A,8000,7998,0,1,0,1,7998,2
2986,A,7925,7925,0,0,0,0,7925,0
2986,T,8000,2,0,0,0,7997,7997,3
2987,C,7927,0,7927,0,0,0,7927,0
2987,G,8000,0,0,8000,0,0,8000,0
2988,C,8001,0,8001,0,0,0,8001,0
2988,T,7923,0,1,0,0,7916,7916,7
2989,A,7964,7964,0,0,0,0,7964,0
2989,T,7918,1,2,0,0,7915,7915,3
2990,G,7920,0,0,7911,0,2,7911,9
2990,G,8000,0,0,8000,0,0,8000,0
2991,G,7977,1,0,7975,0,1,7975,2
2991,T,7991,0,0,0,0,7990,7990,1
2992,G,7999,1,0,7998,0,0,7998,1
2992,T,7977,0,0,0,0,7977,7977,0
2993,C,7975,0,7975,0,0,0,7975,0
2993,C,7999,1,7997,0,0,0,7997,2
2994,T,7970,0,0,0,0,7970,7970,0
2994,T,7997,0,1,0,0,7995,7995,2
2995,G,7997,0,0,7997,0,0,7997,0
2995,G,8000,0,0,8000,0,0,8000,0
2996,A,7997,7995,0,1,0,1,7995,2
2996,C,8000,0,7997,0,0,0,7997,3
2997,C,7998,0,7998,0,0,0,7998,0
2997,C,8000,0,8000,0,0,0,8000,0
2998,A,7996,7996,0,0,0,0,7996,0
2998,A,8001,7998,0,2,0,0,7998,3
2999,G,7998,0,0,7998,0,0,7998,0
2999,T,7982,2,0,0,0,7980,7980,2
3000,A,8000,7998,0,0,0,0,7998,2
3000,T,7985,0,0,0,0,7985,7985,0
3001,A,8000,7998,0,0,0,0,7998,2
3001,T,7999,0,0,0,0,7999,7999,0
3002,A,8000,8000,0,0,0,0,8000,0
3002,C,7998,0,7990,0,0,0,7990,8
3003,C,8001,0,15992,0,0,1,15992,-7991
3004,A,7985,7984,0,0,0,0,7984,1
3004,C,7995,0,7995,0,0,0,7995,0
3005,A,7989,7986,0,0,0,0,7986,3
3005,T,7972,0,0,1,0,7970,7970,2
3006,A,7988,7988,0,0,0,0,7988,0
3006,G,8000,0,0,8000,0,0,8000,0
3007,A,8001,8001,0,0,0,0,8001,0
3007,T,7997,1,0,0,0,7995,7995,2
3008,G,7994,0,0,7994,0,0,7994,0
3008,G,8002,0,0,8001,0,0,8001,1
3009,C,7993,1,7992,0,0,0,7992,1
3009,T,7980,0,0,0,0,7980,7980,0
3010,G,7981,1,0,7980,0,0,7980,1
3010,T,7983,0,0,0,0,7980,7980,3
3011,A,7983,7983,0,0,0,0,7983,0
3011,T,7986,0,0,0,0,7986,7986,0
3012,A,7993,7988,0,1,0,0,7988,5
3012,T,7987,0,0,1,0,7986,7986,1
3013,A,7989,7988,0,0,0,0,7988,1
3013,A,7998,7998,0,0,0,0,7998,0
3014,A,7993,7993,0,0,0,0,7993,0
3014,T,7999,1,0,0,0,7998,7998,1
3015,C,7999,0,7999,0,0,0,7999,0
3015,C,8000,0,7999,0,0,1,7999,1
3016,A,7962,7962,0,0,0,0,7962,0
3016,A,7989,7988,0,1,0,0,7988,1
3017,C,7990,0,7989,0,0,0,7989,1
3017,G,7998,1,0,7996,0,0,7996,2
3018,T,7946,0,2,2,0,7942,7942,4
3018,T,7996,0,0,0,0,7996,7996,0
3019,G,7955,1,0,7954,0,0,7954,1
3019,G,7997,0,0,7997,0,0,7997,0
3020,A,7995,7993,0,0,0,2,7993,2
3020,C,7953,0,7953,0,0,0,7953,0
3021,G,7963,0,0,7961,0,1,7961,2
3021,G,7993,0,0,7991,0,0,7991,2
3022,G,7973,3,1,7969,0,0,7969,4
3022,G,7998,0,0,7997,0,1,7997,1
3023,C,7970,0,7967,0,0,0,7967,3
3023,C,7996,0,7996,0,0,0,7996,0
3024,A,7997,7996,1,0,0,0,7996,1
3024,C,7975,0,7975,0,0,0,7975,0
3025,A,7975,7966,1,0,0,0,7966,9
3025,C,7999,0,7992,0,0,0,7992,7
3026,A,8000,7998,1,0,0,1,7998,2
3026,C,7987,0,7987,0,0,0,7987,0
3027,C,8001,0,7999,0,0,2,7999,2
3027,T,7996,0,0,0,0,7996,7996,0
3028,A,7999,7998,0,0,0,1,7998,1
3028,T,8001,0,0,0,0,8000,8000,1
3029,T,7999,0,0,0,0,7999,7999,0
3029,T,8002,1,1,0,0,8000,8000,2
3030,A,8002,8002,0,0,0,0,8002,0
3030,C,8000,0,7999,0,0,1,7999,1
3031,C,8003,0,8003,0,0,0,8003,0
3031,T,7990,1,0,0,0,7988,7988,2
3032,C,7991,0,7991,0,0,0,7991,0
3032,T,7999,0,1,0,0,7995,7995,4
3033,A,7979,7979,0,0,0,0,7979,0
3033,T,7999,0,1,1,0,7997,7997,2
3034,C,8000,0,7999,0,0,1,7999,1
3034,G,7982,1,0,7980,0,0,7980,2
3035,C,7978,0,7975,0,0,2,7975,3
3035,T,7994,0,1,0,0,7993,7993,1
3036,G,7993,0,0,7993,0,0,7993,0
3036,G,8000,0,0,8000,0,0,8000,0
3037,A,7996,7995,0,0,0,1,7995,1
3037,A,8000,8000,0,0,0,0,8000,0
3038,C,8001,0,7998,0,0,3,7998,3
3038,T,7995,0,0,0,0,7995,7995,0
3039,A,8000,7994,0,0,0,0,7994,6
3039,C,7998,0,7998,0,0,0,7998,0
3040,A,7999,7997,0,1,0,1,7997,2
3040,T,7996,0,1,0,0,7995,7995,1
3041,C,8000,0,7997,1,0,2,7997,3
3041,G,7999,3,0,7996,0,0,7996,3
3042,G,7999,1,0,7998,0,0,7998,1
3042,T,8000,0,1,0,0,7999,7999,1
3043,A,8000,7998,0,1,0,1,7998,2
3043,C,8001,0,8000,0,0,1,8000,1
3044,T,8000,0,0,0,0,8000,8000,0
3044,T,8001,0,0,0,0,8001,8001,0
3045,A,7997,7997,0,0,0,0,7997,0
3045,C,8000,0,7996,0,0,3,7996,4
3046,G,8000,1,0,7990,0,1,7990,10
3046,T,7997,0,1,0,0,7982,7982,15
3047,G,8000,1,0,7999,0,0,7999,1
3047,T,7991,1,1,0,0,7989,7989,2
3048,A,8000,7999,0,0,0,1,7999,1
3048,T,7997,0,0,0,0,7997,7997,0
3049,C,7997,2,7993,0,0,2,7993,4
3049,G,8000,0,0,7989,0,0,7989,11
3050,G,7980,0,0,7979,0,1,7979,1
3050,G,7998,0,0,7998,0,0,7998,0
3051,A,7992,7992,0,0,0,0,7992,0
3051,T,7981,0,0,0,0,7978,7978,3
3052,C,8000,0,7993,0,0,0,7993,7
3052,T,7980,0,1,0,0,7978,7978,2
3053,C,7996,0,7993,0,0,3,7993,3
3053,C,7998,0,7997,0,0,1,7997,1
3054,A,7997,7996,0,0,0,1,7996,1
3054,G,8000,0,0,8000,0,0,8000,0
3055,A,8001,7996,0,0,0,0,7996,5
3055,T,7999,0,0,1,0,7997,7997,2
3056,A,8001,8001,0,0,0,0,8001,0
3056,C,8000,0,7992,0,0,0,7992,8
3057,C,8000,0,8000,0,0,0,8000,0
3057,G,8002,0,0,7997,0,1,7997,5
3058,A,7997,7997,0,0,0,0,7997,0
3058,G,8003,0,0,8002,0,1,8002,1
3059,A,7998,7997,0,1,0,0,7997,1
3059,T,7999,1,0,0,0,7998,7998,1
3060,A,7999,7998,0,0,0,0,7998,1
3060,G,7998,0,0,7996,0,0,7996,2
3061,C,7996,0,7994,0,0,1,7994,2
3061,G,8000,0,0,8000,0,0,8000,0
3062,T,7992,0,1,0,0,7990,7990,2
3062,T,7997,1,0,0,0,7991,7991,6
3063,A,7996,7992,0,0,0,0,7992,4
3063,T,7989,0,0,1,0,7988,7988,1
3064,A,7996,7995,0,1,0,0,7995,1
3064,G,7992,2,0,7989,0,1,7989,3
3065,C,7993,0,7992,0,0,0,7992,1
3065,C,8000,1,7988,0,0,1,7988,12
3066,A,7988,7988,0,0,0,0,7988,0
3066,C,7997,0,7996,0,0,1,7996,1
3067,G,7998,0,0,7998,0,0,7998,0
3067,T,7988,0,0,0,0,7975,7975,13
3068,C,8000,0,7999,0,0,1,7999,1
3068,T,7987,0,0,1,0,7986,7986,1
3069,T,7987,0,1,0,0,7986,7986,1
3069,T,7997,1,1,0,0,7814,7814,183
3070,A,7987,7981,0,0,0,0,7981,6
3070,T,7996,0,0,0,0,7996,7996,0
3071,A,7987,7987,0,0,0,0,7987,0
3071,T,8000,0,0,0,0,8000,8000,0
3072,A,7987,7987,0,0,0,0,7987,0
3072,T,7998,0,0,0,0,7998,7998,0
3073,T,7996,0,0,1,0,7965,7965,31
3073,T,8000,0,1,0,0,7999,7999,1
3074,T,7995,1,0,0,0,7994,7994,1
3074,T,7998,0,0,1,0,7997,7997,1
3075,G,8000,2,0,7998,0,0,7998,2
3075,T,7998,0,0,0,0,7998,7998,0
3076,C,7998,0,7993,0,0,1,7993,5
3076,C,8000,0,7998,0,0,1,7998,2
3077,A,7998,7995,0,1,0,0,7995,3
3077,C,7998,0,7997,0,0,1,7997,1
3078,C,8000,0,8000,0,0,0,8000,0
3078,G,7999,0,0,7999,0,0,7999,0
3079,A,7996,7984,1,0,0,0,7984,12
3079,A,7998,7993,0,1,0,0,7993,5
3080,A,7999,7999,0,0,0,0,7999,0
3080,A,8000,7998,1,1,0,0,7998,2
3081,C,8000,0,7997,1,0,0,7997,3
3081,C,8001,1,8000,0,0,0,8000,1
3082,A,7998,7997,0,1,0,0,7997,1
3082,T,7994,0,0,0,0,7994,7994,0
3083,C,7999,0,7998,0,0,0,7998,1
3083,T,7999,0,1,0,0,7998,7998,1
3084,G,7999,0,0,7933,0,0,7933,66
3084,T,7997,0,0,0,0,7997,7997,0
3085,C,7999,2,7990,0,0,0,7990,9
3085,G,8000,0,0,8000,0,0,8000,0
3086,C,7999,0,7999,0,0,0,7999,0
3086,G,8001,0,0,8000,0,1,8000,1
3087,A,7998,7992,0,2,0,0,7992,6
3087,G,7991,0,0,7990,0,1,7990,1
3088,A,7999,7998,0,1,0,0,7998,1
3088,G,7991,1,0,7990,0,0,7990,1
3089,A,7941,7937,0,3,0,1,7937,4
3089,G,8000,1,0,7990,0,0,7990,10
3090,G,7999,0,1,7997,0,0,7997,2
3090,T,7991,1,0,0,0,7990,7990,1
3091,C,7996,0,7994,0,0,2,7994,2
3091,C,7997,1,7963,0,0,1,7963,34
3092,A,7999,7999,0,0,0,0,7999,0
3092,C,7950,0,7950,0,0,0,7950,0
3093,C,7952,1,7950,0,0,1,7950,2
3093,T,8000,1,1,0,0,7998,7998,2
3094,G,7999,1,0,7998,0,0,7998,1
3094,T,7950,0,0,0,0,7949,7949,1
3095,C,7951,0,7951,0,0,0,7951,0
3095,T,7998,0,0,0,0,7998,7998,0
3096,A,7992,7989,0,0,0,0,7989,3
3096,G,7953,0,0,7953,0,0,7953,0
3097,A,7992,7991,0,0,0,1,7991,1
3097,T,7960,0,0,0,0,7960,7960,0
3098,C,7961,1,7959,0,0,0,7959,2
3098,C,7988,0,7986,0,0,1,7986,2
3099,G,7961,0,0,7948,0,0,7948,13
3099,T,7970,1,2,0,0,7967,7967,3
3100,C,7990,0,7990,0,0,0,7990,0
3100,G,7964,1,0,7962,0,1,7962,2
3101,A,7964,7911,0,1,0,0,7911,53
3101,G,7990,0,0,7990,0,0,7990,0
3102,A,7964,7963,0,0,0,0,7963,1
3102,C,8000,1,7995,0,0,0,7995,5
3103,A,7963,7963,0,0,0,0,7963,0
3103,C,8000,1,7999,0,0,0,7999,1
3104,A,7962,7961,0,0,0,1,7961,1
3104,T,8000,2,1,0,0,7989,7989,11
3105,T,7980,1,0,0,0,7979,7979,1
3105,T,8000,0,0,0,0,8000,8000,0
3106,C,7998,0,7997,0,0,0,7997,1
3106,G,8001,0,0,8001,0,0,8001,0
3107,A,8001,8001,0,0,0,0,8001,0
3107,T,7996,0,0,0,0,7994,7994,2
3108,T,7996,0,0,0,0,7996,7996,0
3108,T,8002,1,0,0,0,8001,8001,1
3109,C,7996,0,15989,0,0,1,15989,-7993
3110,A,7996,7969,0,0,0,0,7969,27
3110,G,7994,1,0,7992,0,0,7992,2
3111,A,7996,7995,1,0,0,0,7995,1
3111,T,7997,1,1,2,0,7982,7982,15
3112,A,7996,7993,1,0,0,0,7993,3
3112,T,7998,0,1,0,0,7997,7997,1
3113,C,7997,0,7986,0,0,0,7986,11
3113,G,8000,0,0,7974,0,0,7974,26
3114,C,7993,2,7989,0,0,2,7989,4
3114,G,8000,0,0,8000,0,0,8000,0
3115,G,7999,1,0,7997,0,0,7997,2
3115,T,7990,0,1,0,0,7985,7985,5
3116,A,7999,7995,0,1,0,0,7995,4
3116,T,7990,0,1,1,0,7988,7988,2
3117,A,7999,7997,0,1,0,0,7997,2
3117,T,7990,0,1,0,0,7989,7989,1
3118,C,7997,0,7997,0,0,0,7997,0
3118,C,7999,0,7993,0,0,2,7993,6
3119,C,8000,1,7997,1,0,1,7997,3
3119,G,7999,0,0,7999,0,0,7999,0
3120,G,8000,1,1,7991,0,0,7991,9
3120,T,8000,0,0,0,0,7999,7999,1
3121,C,8000,1,7985,0,0,0,7985,15
3121,G,8001,1,0,8000,0,0,8000,1
3122,A,8002,7999,0,3,0,0,7999,3
3122,C,7986,0,7983,1,0,2,7983,3
3123,G,7999,2,0,7997,0,0,7997,2
3123,G,8003,2,0,8000,0,0,8000,3
3124,A,8000,7999,0,0,0,1,7999,1
3124,C,8004,0,8002,0,0,2,8002,2
3125,T,8000,1,1,0,0,15997,15997,-7997
3126,C,8001,0,7999,0,0,2,7999,2
3126,G,8001,0,0,8001,0,0,8001,0
3127,A,8002,7998,0,0,0,0,7998,4
3127,C,7998,0,7998,0,0,0,7998,0
3128,A,7993,7991,0,0,0,1,7991,2
3128,A,8003,8001,0,1,0,1,8001,2
3129,T,7999,0,0,0,0,7998,7998,1
3129,T,8004,1,0,0,0,8002,8002,2
3130,C,8000,0,7999,1,0,0,7999,1
3130,G,7997,1,0,7996,0,0,7996,1
3131,A,8000,7995,0,0,0,1,7995,5
3131,T,8001,1,0,0,0,7994,7994,7
3132,A,7999,7998,0,0,0,1,7998,1
3132,T,7998,0,1,0,0,7997,7997,1
3133,G,7998,1,0,7997,0,0,7997,1
3133,G,8000,1,0,7998,0,1,7998,2
3134,C,7999,0,7997,0,0,2,7997,2
3134,C,8001,0,7998,0,0,1,7998,3
3135,A,7997,7995,1,1,0,0,7995,2
3135,C,7982,1,7980,0,0,1,7980,2
3136,A,8000,7997,1,0,0,1,7997,3
3136,G,7999,0,0,7991,0,0,7991,8
3137,G,7994,1,0,7993,0,0,7993,1
3137,T,8001,0,0,0,0,8001,8001,0
3138,A,8002,8000,0,1,0,0,8000,2
3138,C,7997,0,7997,0,0,0,7997,0
3139,C,8002,1,7990,0,0,1,7990,12
3139,T,7995,0,0,0,0,7994,7994,1
3140,A,7993,7991,0,1,0,1,7991,2
3140,C,7998,1,7996,0,0,0,7996,2
3141,A,7991,7971,0,0,0,0,7971,20
3141,C,7999,0,7991,0,0,2,7991,8
3142,A,7994,7993,0,1,0,0,7993,1
3142,C,8000,0,8000,0,0,0,8000,0
3143,A,7994,7992,1,0,0,0,7992,2
3143,T,8000,0,0,0,0,8000,8000,0
3144,C,7999,2,7997,0,0,0,7997,2
3144,C,8001,0,8001,0,0,0,8001,0
3145,G,7991,0,0,7991,0,0,7991,0
3145,T,7995,0,0,0,0,7994,7994,1
3146,A,7994,7992,0,1,0,0,7992,2
3146,C,7998,1,7996,0,0,0,7996,2
3147,C,7991,0,7988,0,0,3,7988,3
3147,G,7996,0,0,7996,0,0,7996,0
3148,A,7996,7993,0,0,0,0,7993,3
3148,G,7999,1,0,7997,0,1,7997,2
3149,A,7996,7995,1,0,0,0,7995,1
3149,A,7998,7998,0,0,0,0,7998,0
3150,C,7990,0,7989,0,0,1,7989,1
3150,G,8000,0,0,8000,0,0,8000,0
3151,C,8001,0,7999,0,0,1,7999,2
3151,G,7997,3,0,7992,0,0,7992,5
3152,A,7999,7997,0,1,0,0,7997,2
3152,G,8002,1,0,8001,0,0,8001,1
3153,A,7994,7993,0,1,0,0,7993,1
3153,T,8003,0,0,0,0,8003,8003,0
3154,C,7999,0,7998,0,0,1,7998,1
3154,G,8003,1,0,8002,0,0,8002,1
3155,A,8004,8003,0,1,0,0,8003,1
3155,T,7997,0,0,0,0,7997,7997,0
3156,A,7998,7998,0,0,0,0,7998,0
3156,C,8004,0,8004,0,0,0,8004,0
3157,A,8004,8003,1,0,0,0,8003,1
3157,T,7999,0,0,0,0,7999,7999,0
3158,C,8000,1,7999,0,0,0,7999,1
3158,C,8005,1,7997,0,0,0,7997,8
3159,C,8000,0,8000,0,0,0,8000,0
3159,G,8001,2,0,7998,0,0,7998,3
3160,A,8001,8000,0,0,0,0,8000,1
3160,C,7999,0,7998,0,0,1,7998,1
3161,A,7986,7972,0,0,0,1,7972,14
3161,C,8002,0,8002,0,0,0,8002,0
3162,A,7990,7990,0,0,0,0,7990,0
3162,G,7998,2,0,7996,0,0,7996,2
3163,A,7999,7997,0,2,0,0,7997,2
3163,G,7994,0,0,7992,0,2,7992,2
3164,T,7997,0,0,0,0,7996,7996,1
3164,T,7999,0,0,0,0,7999,7999,0
3165,C,7993,0,7993,0,0,0,7993,0
3165,G,7999,1,0,7998,0,0,7998,1
3166,C,8000,0,7988,0,0,1,7988,12
3166,T,7990,0,0,0,0,7990,7990,0
3167,C,7992,0,7992,0,0,0,7992,0
3167,C,8000,0,7999,0,0,1,7999,1
3168,T,7992,0,0,0,0,7986,7986,6
3168,T,7994,1,0,0,0,7993,7993,1
3169,G,7998,0,0,7998,0,0,7998,0
3169,T,7994,0,0,1,0,7992,7992,2
3170,G,7998,0,0,7972,0,2,7972,26
3170,T,8000,1,0,0,0,7999,7999,1
3171,A,8001,8001,0,0,0,0,8001,0
3171,G,7997,0,1,7996,0,0,7996,1
3172,C,7997,0,7990,0,0,0,7990,7
3172,G,8002,0,0,8002,0,0,8002,0
3173,C,7980,1,7979,0,0,0,7979,1
3173,C,8001,0,7999,0,0,2,7999,2
3174,A,7979,7974,0,2,0,0,7974,5
3174,G,7975,0,0,7967,0,0,7967,8
3175,A,7980,7980,0,0,0,0,7980,0
3175,G,7998,0,0,7998,0,0,7998,0
3176,C,7999,1,7992,0,0,2,7992,7
3176,T,7974,0,0,0,0,7974,7974,0
3177,C,7999,1,7997,0,0,1,7997,2
3177,G,8000,1,0,7993,0,2,7993,7
3178,G,8000,1,0,7999,0,0,7999,1
3178,T,7999,0,1,0,0,7995,7995,4
3179,C,7999,0,7997,0,0,2,7997,2
3179,T,7998,0,0,2,0,7996,7996,2
3180,A,7998,7997,0,0,0,0,7997,1
3180,G,7999,1,0,7998,0,0,7998,1
3181,A,7999,7999,0,0,0,0,7999,0
3181,C,8000,1,7997,0,0,0,7997,3
3182,C,8000,0,8000,0,0,0,8000,0
3182,G,8001,1,1,7998,0,1,7998,3
3183,A,8000,7994,0,1,0,0,7994,6
3183,C,8002,0,7991,0,0,0,7991,11
3184,A,8001,8001,0,0,0,0,8001,0
3184,C,7970,1,7966,0,0,2,7966,4
3185,C,8000,0,8000,0,0,0,8000,0
3185,T,7969,0,2,0,0,7961,7961,8
3186,G,7995,0,3,7992,0,0,7992,3
3186,T,7971,0,0,0,0,7971,7971,0
3187,G,7999,0,0,7993,0,0,7993,6
3187,T,7995,0,0,0,0,7995,7995,0
3188,G,8000,0,0,8000,0,0,8000,0
3188,T,7984,0,1,0,0,7983,7983,1
3189,C,8000,2,7998,0,0,0,7998,2
3189,G,7996,0,0,7996,0,0,7996,0
3190,C,7996,0,7996,0,0,0,7996,0
3190,T,7996,0,0,0,0,7996,7996,0
3191,A,7994,7992,0,1,0,0,7992,2
3191,G,7996,1,0,7995,0,0,7995,1
3192,C,7995,0,7992,1,0,2,7992,3
3192,T,7999,0,0,0,0,7988,7988,11
3193,A,7990,7981,0,1,0,0,7981,9
3193,T,7998,1,0,0,0,7997,7997,1
3194,A,8000,7999,0,0,0,1,7999,1
3194,G,7999,1,0,7998,0,0,7998,1
3195,A,8000,7999,0,1,0,0,7999,1
3195,C,8000,0,7999,0,0,1,7999,1
3196,C,8001,1,7999,0,0,0,7999,2
3196,T,7976,0,0,0,0,7974,7974,2
3197,T,7983,0,1,1,0,7981,7981,2
3197,T,8001,1,1,0,0,7999,7999,2
3198,A,7995,7995,0,0,0,0,7995,0
3198,G,7986,0,0,7967,0,1,7967,19
3199,G,7989,0,1,7987,0,1,7987,2
3199,T,7995,2,0,0,0,7986,7986,9
3200,C,7990,0,7989,0,0,1,7989,1
3200,T,7996,0,0,1,0,7995,7995,1
3201,A,7974,7972,0,1,0,1,7972,2
3201,A,7997,7996,0,0,0,0,7996,1
3202,A,7998,7998,0,0,0,0,7998,0
3202,G,7978,0,0,7975,0,0,7975,3
3203,C,7971,0,7967,1,0,1,7967,4
3203,C,7998,0,7998,0,0,0,7998,0
3204,G,7982,0,1,7980,0,0,7980,2
3204,T,7996,1,1,0,0,7994,7994,2
3205,C,7999,0,7986,0,0,0,7986,13
3205,G,7979,0,0,7972,0,0,7972,7
3206,C,7997,0,7996,0,0,1,7996,1
3206,G,7984,0,0,7984,0,0,7984,0
3207,C,7981,0,7981,0,0,0,7981,0
3207,T,7997,0,1,0,0,7996,7996,1
3208,A,7999,7996,1,0,0,0,7996,3
3208,G,7988,0,0,7988,0,0,7988,0
3209,A,7987,7984,0,0,0,0,7984,3
3209,T,8000,1,2,0,0,7997,7997,3
3210,A,7998,7998,0,0,0,0,7998,0
3210,C,8001,1,7999,0,0,0,7999,2
3211,C,7999,0,7997,0,0,1,7997,2
3211,G,8001,2,0,7998,0,0,7998,3
3212,C,8001,0,7995,0,0,0,7995,6
3212,T,7999,1,0,0,0,7997,7997,2
3213,A,8000,8000,0,0,0,0,8000,0
3213,C,8001,1,8000,0,0,0,8000,1
3214,A,7993,7993,0,0,0,0,7993,0
3214,C,8001,0,8001,0,0,0,8001,0
3215,G,7996,0,0,7990,0,0,7990,6
3215,T,8001,0,0,0,0,8000,8000,1
3216,G,7999,0,1,7997,0,1,7997,2
3216,T,8002,0,0,0,0,8002,8002,0
3217,A,8001,8000,0,1,0,0,8000,1
3217,T,7999,0,2,0,0,7997,7997,2
3218,A,7998,7997,0,0,0,0,7997,1
3218,C,8002,0,8001,0,0,1,8001,1
3219,T,7992,1,1,0,0,7988,7988,4
3219,T,8000,0,0,0,0,8000,8000,0
3220,C,7991,0,7991,0,0,0,7991,0
3220,T,7990,1,0,0,0,7989,7989,1
3221,A,7993,7992,0,0,0,0,7992,1
3221,T,7990,0,0,0,0,7990,7990,0
3222,A,7977,7977,0,0,0,0,7977,0
3222,C,7999,0,7999,0,0,0,7999,0
3223,G,7978,0,0,7978,0,0,7978,0
3223,T,7998,0,1,0,0,7996,7996,2
3224,C,7980,0,7978,0,0,1,7978,2
3224,C,7997,0,7990,0,0,0,7990,7
3225,C,7932,0,7932,0,0,0,7932,0
3225,T,7979,0,0,0,0,7977,7977,2
3226,A,7928,7923,0,2,0,0,7923,5
3226,T,7978,0,1,0,0,7977,7977,1
3227,A,7938,7936,1,0,0,1,7936,2
3227,C,7977,0,7894,0,0,1,7894,83
3228,C,7976,0,7975,0,0,1,7975,1
3228,T,7939,1,0,0,0,7937,7937,2
3229,C,7946,0,7918,0,0,1,7918,28
3229,C,7980,0,7978,0,0,2,7978,2
3230,C,7949,1,7948,0,0,0,7948,1
3230,G,7980,0,3,7973,0,0,7973,7
3231,C,7940,1,7937,0,0,1,7937,3
3231,G,7982,0,0,7982,0,0,7982,0
3232,C,7982,0,7980,0,0,2,7980,2
3232,G,7948,1,0,7946,0,1,7946,2
3233,A,7949,7944,0,0,0,0,7944,5
3233,A,7982,7979,0,0,0,0,7979,3
3234,A,7950,7949,0,0,0,0,7949,1
3234,A,7999,7999,0,0,0,0,7999,0
3235,C,8000,1,7998,0,0,1,7998,2
3235,T,7952,0,0,0,0,7950,7950,2
3236,A,7962,7962,0,0,0,0,7962,0
3236,A,7999,7993,0,0,0,0,7993,6
3237,A,8000,7994,0,5,0,0,7994,6
3237,T,7970,0,0,0,0,7969,7969,1
3238,C,7969,1,7961,0,0,1,7961,8
3238,T,7998,1,0,0,0,7988,7988,10
3239,C,7968,0,7966,0,0,2,7966,2
3239,T,8000,0,1,0,0,7998,7998,2
3240,A,7999,7995,0,4,0,0,7995,4
3240,G,7972,1,0,7969,0,0,7969,3
3241,A,7973,7970,0,1,0,1,7970,3
3241,A,8000,7998,0,0,0,1,7998,2
3242,G,7996,0,0,7996,0,0,7996,0
3242,T,8000,0,0,0,0,8000,8000,0
3243,A,7993,7992,0,0,0,0,7992,1
3243,A,7998,7998,0,0,0,0,7998,0
3244,G,7999,0,0,7997,0,0,7997,2
3244,T,7997,0,0,0,0,7997,7997,0
3245,A,7978,7977,0,0,0,0,7977,1
3245,C,7994,0,7993,0,0,1,7993,1
3246,C,7993,0,7993,0,0,0,7993,0
3246,G,7998,0,1,7936,0,1,7936,62
3247,G,7999,0,0,7998,0,1,7998,1
3247,T,7976,0,0,0,0,7976,7976,0
3248,G,7997,1,0,7993,0,0,7993,4
3248,G,8000,1,0,7999,0,0,7999,1
3249,A,8000,7999,0,1,0,0,7999,1
3249,G,8000,1,0,7998,0,0,7998,2
3250,A,7998,7997,0,1,0,0,7997,1
3250,T,7998,0,1,0,0,7997,7997,1
3251,C,7991,0,7989,0,0,1,7989,2
3251,T,7998,0,0,1,0,7997,7997,1
3252,A,7997,7995,1,0,0,0,7995,2
3252,G,7997,0,0,7991,0,0,7991,6
3253,C,7999,0,7973,0,0,0,7973,26
3253,G,7997,0,0,7997,0,0,7997,0
3254,A,7995,7992,0,2,0,1,7992,3
3254,C,7999,2,7997,0,0,0,7997,2
3255,C,7998,1,7996,0,0,1,7996,2
3255,G,7999,1,0,7991,0,0,7991,8
3256,G,7997,1,0,7992,0,0,7992,5
3256,G,7999,0,0,7999,0,0,7999,0
3257,A,7998,7995,0,1,0,1,7995,3
3257,C,7981,0,7978,0,0,2,7978,3
3258,G,7998,0,0,7990,0,2,7990,8
3258,G,8000,0,0,7999,0,0,7999,1
3259,A,7997,7994,0,0,0,0,7994,3
3259,G,8000,1,0,7999,0,0,7999,1
3260,A,8001,8000,0,0,0,0,8000,1
3260,G,7997,1,0,7996,0,0,7996,1
3261,A,7994,7988,0,1,0,0,7988,6
3261,T,8001,0,0,0,0,8001,8001,0
3262,A,7976,7975,0,0,0,1,7975,1
3262,A,8000,7982,0,0,0,0,7982,18
3263,A,8001,8001,0,0,0,0,8001,0
3263,G,7999,0,0,7999,0,0,7999,0
3264,A,8000,7999,0,0,0,1,7999,1
3264,T,8000,1,0,0,0,7997,7997,3
3265,G,8001,0,0,8001,0,0,8001,0
3265,T,8001,0,0,0,0,8001,8001,0
3266,C,8000,0,7998,0,0,2,7998,2
3266,T,8000,1,1,1,0,7996,7996,4
3267,A,7996,7987,0,1,0,0,7987,9
3267,T,7986,0,2,0,0,7983,7983,3
3268,A,7999,7997,1,1,0,0,7997,2
3268,G,7988,2,0,7986,0,0,7986,2
3269,C,7992,0,7989,0,0,3,7989,3
3269,C,8000,0,7993,0,0,2,7993,7
3270,A,7991,7985,1,4,0,0,7985,6
3270,C,8000,0,8000,0,0,0,8000,0
3271,G,7999,0,0,7989,0,0,7989,10
3271,T,7997,0,0,0,0,7997,7997,0
3272,A,7987,7986,0,1,0,0,7986,1
3272,G,7992,1,0,7991,0,0,7991,1
3273,A,7994,7994,0,0,0,0,7994,0
3273,C,7990,0,7988,0,0,1,7988,2
3274,A,7992,7989,1,0,0,0,7989,3
3274,C,8000,0,7989,0,0,0,7989,11
3275,C,7998,0,7998,0,0,0,7998,0
3275,T,7999,0,0,0,0,7997,7997,2
3276,A,7998,7997,0,0,0,0,7997,1
3276,C,8000,0,7995,0,0,0,7995,5
3277,C,7995,0,7995,0,0,0,7995,0
3277,C,7999,0,7997,0,0,1,7997,2
3278,T,7989,2,0,0,0,7986,7986,3
3278,T,8000,1,1,0,0,7996,7996,4
3279,C,7991,0,7991,0,0,0,7991,0
3279,T,8001,0,0,1,0,8000,8000,1
3280,A,7989,7981,0,0,0,0,7981,8
3280,C,8001,0,8001,0,0,0,8001,0
3281,A,7998,7997,0,0,0,1,7997,1
3281,T,7992,0,0,0,0,7992,7992,0
3282,G,8000,1,0,7998,0,0,7998,2
3282,T,7998,0,0,0,0,7997,7997,1
3283,C,7995,1,7988,0,0,4,7988,7
3283,C,7998,0,7962,0,0,1,7962,36
3284,C,7994,0,7994,0,0,0,7994,0
3284,G,7999,0,1,7997,0,0,7997,2
3285,C,7977,1,7974,0,0,1,7974,3
3285,C,7998,1,7995,1,0,0,7995,3
3286,G,7984,1,0,7981,0,1,7981,3
3286,T,7968,0,0,0,0,7968,7968,0
3287,A,7997,7996,1,0,0,0,7996,1
3287,C,7972,0,7969,0,0,1,7969,3
3288,G,7968,0,0,7959,0,0,7959,9
3288,T,7998,0,0,0,0,7997,7997,1
3289,C,7998,0,7997,0,0,1,7997,1
3289,G,7983,2,0,7979,0,1,7979,4
3290,C,7985,1,7955,0,0,1,7955,30
3290,T,7985,0,1,0,0,7984,7984,1
3291,A,7998,7995,0,0,0,3,7995,3
3291,C,7999,0,7998,0,0,1,7998,1
3292,C,7997,0,7994,0,0,2,7994,3
3292,T,7999,0,1,0,0,7998,7998,1
3293,C,7998,0,7994,0,0,0,7994,4
3293,T,7997,1,0,1,0,7992,7992,5
3294,C,7998,1,7995,0,0,1,7995,3
3294,T,7998,0,2,0,0,7995,7995,3
3295,C,7998,0,7978,0,0,1,7978,20
3295,G,7995,1,0,7993,0,0,7993,2
3296,A,7992,7989,0,2,0,0,7989,3
3296,C,8000,1,7998,0,0,0,7998,2
3297,G,7999,2,0,15984,0,0,15984,-7985
3298,A,7997,7997,0,0,0,0,7997,0
3298,G,8000,2,0,7998,0,0,7998,2
3299,C,8000,1,7998,0,0,1,7998,2
3299,T,7998,0,0,0,0,7998,7998,0
3300,C,7993,0,7989,0,0,0,7989,4
3300,T,7998,0,0,0,0,7997,7997,1
3301,C,7982,1,7980,0,0,1,7980,2
3301,G,7991,0,0,7981,0,0,7981,10
3302,G,7986,1,1,7982,0,0,7982,4
3302,G,7992,1,0,7990,0,0,7990,2
3303,A,7988,7988,0,0,0,0,7988,0
3303,C,7993,0,7991,1,0,1,7991,2
3304,G,7990,0,0,7974,0,1,7974,16
3304,T,7993,0,0,0,0,7993,7993,0
3305,G,7998,1,0,7996,0,1,7996,2
3305,G,7999,1,0,7982,0,0,7982,17
3306,A,7988,7982,0,0,0,0,7982,6
3306,G,8000,1,0,7999,0,0,7999,1
3307,A,7994,7994,0,0,0,0,7994,0
3307,T,8002,1,1,0,0,7976,7976,26
3308,T,7998,0,2,0,0,7996,7996,2
3308,T,8003,1,0,0,0,8002,8002,1
3309,A,7998,7997,0,0,0,0,7997,1
3309,T,8003,1,1,0,0,8000,8000,3
3310,A,8000,8000,0,0,0,0,8000,0
3310,T,7997,0,1,0,0,7996,7996,1
3311,C,7997,0,7997,0,0,0,7997,0
3311,T,8002,3,0,1,0,7994,7994,8
3312,G,7996,1,0,7994,0,0,7994,2
3312,T,8001,0,0,0,0,8001,8001,0
3313,A,7997,7989,0,0,0,0,7989,8
3313,G,8001,2,0,7999,0,0,7999,2
3314,A,7996,7996,0,0,0,0,7996,0
3314,C,7999,1,7996,0,0,0,7996,3
3315,A,7998,7998,0,0,0,0,7998,0
3315,T,7975,0,0,0,0,7975,7975,0
3316,G,8000,2,0,7998,0,0,7998,2
3316,T,7998,0,0,0,0,7998,7998,0
3317,A,8000,7995,0,2,0,0,7995,5
3317,C,7995,0,7994,0,0,0,7994,1
3318,G,7989,0,0,7929,0,0,7929,60
3318,T,7999,0,0,1,0,7998,7998,1
3319,A,8001,7989,0,0,0,0,7989,12
3319,G,7994,0,0,7992,0,1,7992,2
3320,A,8002,8002,0,0,0,0,8002,0
3320,G,7993,0,0,7960,0,0,7960,33
3321,A,8004,8003,0,0,0,1,8003,1
3321,G,7960,0,0,7959,0,0,7959,1
3322,C,7955,0,7950,1,0,1,7950,5
3322,T,8002,0,0,0,0,8002,8002,0
3323,C,8002,0,8001,0,0,1,8001,1
3323,G,7957,1,1,7955,0,0,7955,2
3324,C,7962,0,7959,1,0,0,7959,3
3324,T,8001,0,1,1,0,7999,7999,2
3325,G,7961,2,1,7955,0,0,7955,6
3325,G,7994,0,0,7991,0,0,7991,3
3326,C,7962,1,7959,0,0,0,7959,3
3326,G,8000,0,0,8000,0,0,8000,0
3327,A,7997,7995,0,0,0,0,7995,2
3327,C,7963,0,7962,0,0,1,7962,1
3328,G,8000,0,0,7998,0,1,7998,2
3328,T,7958,0,1,0,0,7957,7957,1
3329,C,7997,0,7982,0,0,2,7982,15
3329,G,7963,2,0,7950,0,0,7950,13
3330,C,7993,1,7991,1,0,0,7991,2
3330,G,7964,1,0,7963,0,0,7963,1
3331,C,7955,0,7948,1,0,1,7948,7
3331,G,7999,1,1,7992,0,0,7992,7
3332,C,7955,0,7955,0,0,0,7955,0
3332,G,8000,0,0,8000,0,0,8000,0
3333,T,7928,0,0,0,0,7928,7928,0
3333,T,8001,0,1,0,0,7999,7999,2
3334,C,7929,0,7922,0,0,1,7922,7
3334,G,8002,0,0,8001,0,0,8001,1
3335,A,8000,7998,0,0,0,0,7998,2
3335,C,7925,0,7925,0,0,0,7925,0
3336,G,7926,0,0,7924,0,1,7924,2
3336,G,8001,0,0,7999,0,0,7999,2
3337,C,7925,0,7925,0,0,0,7925,0
3337,C,8002,0,8001,0,0,0,8001,1
3338,G,7924,1,0,7923,0,0,7923,1
3338,G,8002,1,0,8001,0,0,8001,1
3339,C,7925,0,7915,1,0,1,7915,10
3339,T,7999,0,1,0,0,7995,7995,4
3340,C,7925,0,7923,1,0,1,7923,2
3340,G,7996,0,0,7966,0,0,7966,30
3341,G,7934,0,0,7902,0,0,7902,32
3341,G,8000,1,0,7997,0,2,7997,3
3342,G,7938,1,0,7936,0,1,7936,2
3342,G,8001,0,0,8001,0,0,8001,0
3343,G,7952,0,0,7951,0,1,7951,1
3343,T,8001,0,3,0,0,7997,7997,4
3344,C,7998,0,7998,0,0,0,7998,0
3344,T,7951,0,0,0,0,7878,7878,73
3345,T,7948,0,1,0,0,7947,7947,1
3345,T,7996,0,0,0,0,7996,7996,0
3346,C,8000,1,7997,0,0,1,7997,3
3346,T,7949,0,0,0,0,7949,7949,0
3347,G,8001,0,0,8000,0,1,8000,1
3347,T,7949,0,2,0,0,7946,7946,3
3348,C,8002,1,8000,0,0,0,8000,2
3348,G,7951,1,0,7940,0,0,7940,11
3349,G,7952,0,0,7951,0,0,7951,1
3349,G,8003,3,0,7996,0,1,7996,7
3350,C,7948,0,7944,0,0,3,7944,4
3350,G,7999,1,0,7997,0,0,7997,2
3351,G,7948,0,0,7948,0,0,7948,0
3351,T,7994,0,1,1,0,7990,7990,4
3352,A,7997,7996,0,0,0,0,7996,1
3352,C,7959,0,7950,0,0,0,7950,9
3353,C,7961,0,7961,0,0,0,7961,0
3353,T,8000,1,2,0,0,7997,7997,3
3354,C,8001,0,7999,0,0,1,7999,2
3354,T,7963,0,0,0,0,7963,7963,0
3355,A,7996,7993,0,0,0,3,7993,3
3355,C,7964,0,7938,0,0,0,7938,26
3356,C,7965,0,7961,0,0,4,7961,4
3356,T,7999,0,1,0,0,7993,7993,6
3357,C,7963,0,7962,1,0,0,7962,1
3357,T,7994,1,0,0,0,7993,7993,1
3358,G,7963,0,3,7956,0,1,7956,7
3358,G,7999,0,0,7997,0,0,7997,2
3359,C,7961,0,7959,2,0,0,7959,2
3359,C,7981,0,7980,0,0,0,7980,1
3360,A,7978,7977,0,0,0,1,7977,1
3360,G,7961,1,0,7907,0,1,7907,54
3361,G,7961,1,0,7960,0,0,7960,1
3361,G,7999,1,0,7997,0,0,7997,2
3362,C,7998,1,7997,0,0,0,7997,1
3362,G,7963,1,0,7962,0,0,7962,1
3363,A,7995,7993,0,0,0,0,7993,2
3363,C,7957,0,7952,0,0,0,7952,5
3364,C,7996,1,7993,1,0,0,7993,3
3364,G,7959,3,2,7952,0,0,7952,7
3365,C,7964,0,7759,4,0,1,7759,205
3365,T,7973,0,0,0,0,7972,7972,1
3366,C,7963,0,7961,1,0,1,7961,2
3366,G,7991,1,0,7928,0,1,7928,63
3367,C,7966,0,7966,0,0,0,7966,0
3367,G,7999,0,0,7999,0,0,7999,0
3368,C,7967,0,7966,0,0,1,7966,1
3368,G,7999,0,0,7999,0,0,7999,0
3369,C,7968,0,7967,0,0,1,7967,1
3369,G,8000,1,1,7998,0,0,7998,2
3370,C,7963,0,7963,0,0,0,7963,0
3370,C,7989,0,7987,0,0,1,7987,2
3371,C,7990,1,7989,0,0,0,7989,1
3371,T,7963,0,1,0,0,7962,7962,1
3372,A,7982,7982,0,0,0,0,7982,0
3372,C,7962,0,7961,0,0,1,7961,1
3373,G,7963,3,0,7959,0,0,7959,4
3373,G,8000,0,0,8000,0,0,8000,0
3374,A,8001,8000,0,1,0,0,8000,1
3374,T,7960,0,1,0,0,7959,7959,1
3375,C,7962,0,7962,0,0,0,7962,0
3375,T,8002,0,0,0,0,8002,8002,0
3376,A,7951,7950,0,0,0,0,7950,1
3376,G,8000,0,0,7991,0,0,7991,9
3377,C,7955,0,7954,0,0,1,7954,1
3377,G,7996,0,0,7996,0,0,7996,0
3378,G,7952,0,0,7948,0,0,7948,4
3378,T,7995,0,0,1,0,7994,7994,1
3379,A,8000,7997,0,0,0,0,7997,3
3379,G,7953,1,0,7952,0,0,7952,1
3380,A,8000,7995,1,2,0,2,7995,5
3380,C,7951,0,7950,0,0,1,7950,1
3381,G,7946,2,0,7944,0,0,7944,2
3381,G,8000,0,0,8000,0,0,8000,0
3382,A,7941,7941,0,0,0,0,7941,0
3382,C,7998,0,7976,0,0,0,7976,22
3383,C,7987,0,7987,0,0,0,7987,0
3383,G,7946,0,0,7945,0,1,7945,1
3384,C,7947,0,7945,0,0,2,7945,2
3384,C,7977,1,7976,0,0,0,7976,1
3385,G,7949,2,0,7947,0,0,7947,2
3385,T,7977,0,0,0,0,7977,7977,0
3386,C,7962,0,7962,0,0,0,7962,0
3386,C,8000,1,7948,0,0,0,7948,52
3387,C,8001,0,8000,0,0,1,8000,1
3387,T,7962,0,0,1,0,7961,7961,1
3388,C,8001,1,7999,0,0,1,7999,2
3388,G,7964,1,0,7963,0,0,7963,1
3389,C,7964,0,7954,0,0,3,7954,10
3389,G,8002,1,0,8000,0,0,8000,2
3390,C,7964,1,7962,1,0,0,7962,2
3390,T,7994,0,0,0,0,7994,7994,0
3391,A,7965,7962,2,1,0,0,7962,3
3391,A,7999,7997,0,0,0,1,7997,2
3392,C,7966,0,7966,0,0,0,7966,0
3392,T,7999,0,0,1,0,7997,7997,2
3393,C,7990,1,7988,0,0,1,7988,2
3393,G,7967,0,0,7967,0,0,7967,0
3394,G,7999,1,0,7998,0,0,7998,1
3394,T,7968,0,0,0,0,7967,7967,1
3395,C,7965,0,7964,0,0,1,7964,1
3395,T,7994,0,0,0,0,7993,7993,1
3396,A,7963,7960,0,1,0,1,7960,3
3396,A,7994,7994,0,0,0,0,7994,0
3397,G,7964,0,0,7963,0,0,7963,1
3397,G,8000,0,0,7998,0,1,7998,2
3398,A,7964,7963,0,1,0,0,7963,1
3398,T,7977,1,0,0,0,7976,7976,1
3399,C,7962,0,7962,0,0,0,7962,0
3399,T,7998,0,0,0,0,7997,7997,1
3400,A,7996,7994,0,1,0,1,7994,2
3400,G,7963,0,0,7962,0,0,7962,1
3401,A,7957,7954,0,0,0,0,7954,3
3401,T,7996,0,1,0,0,7995,7995,1
3402,A,7953,7953,0,0,0,0,7953,0
3402,C,8000,1,7998,0,0,0,7998,2
3403,G,7964,3,0,7913,0,0,7913,51
3403,T,7991,0,2,0,0,7989,7989,2
3404,A,7999,7998,0,0,0,1,7998,1
3404,G,7964,0,0,7964,0,0,7964,0
3405,C,8000,0,7998,0,0,2,7998,2
3405,G,7965,0,0,7963,0,0,7963,2
3406,A,7987,7986,0,0,0,0,7986,1
3406,C,7959,0,7957,0,0,1,7957,2
3407,C,7999,0,7998,0,0,0,7998,1
3407,G,7961,2,0,7958,0,0,7958,3
3408,C,7963,0,7961,0,0,2,7961,2
3408,G,7986,1,0,7982,0,1,7982,4
3409,A,7962,7960,0,1,0,0,7960,2
3409,A,7997,7997,0,0,0,0,7997,0
3410,C,7998,0,7995,2,0,0,7995,3
3410,G,7961,0,0,7957,0,0,7957,4
3411,G,7961,1,0,7960,0,0,7960,1
3411,G,7995,0,0,7906,0,0,7906,89
3412,A,7953,7952,0,1,0,0,7952,1
3412,G,7997,0,0,7997,0,0,7997,0
3413,G,7955,0,0,7955,0,0,7955,0
3413,G,7997,0,0,7996,0,1,7996,1
3414,C,7927,1,7926,0,0,0,7926,1
3414,G,7999,1,0,7997,0,1,7997,2
3415,A,8000,7988,0,11,0,0,7988,12
3415,G,7961,1,0,7960,0,0,7960,1
3416,G,7999,0,0,7999,0,0,7999,0
3416,T,7963,0,1,0,0,7962,7962,1
3417,C,7963,0,7954,0,0,0,7954,9
3417,T,7999,0,0,2,0,7997,7997,2
3418,C,7964,1,7963,0,0,0,7963,1
3418,C,7997,0,7996,0,0,1,7996,1
3419,A,7998,7995,0,2,0,0,7995,3
3419,T,7959,0,0,0,0,7958,7958,1
3420,G,7962,1,0,7961,0,0,7961,1
3420,G,7998,1,0,7995,0,2,7995,3
3421,A,7961,7960,0,0,0,0,7960,1
3421,G,8000,1,0,7999,0,0,7999,1
3422,C,8001,1,7999,0,0,0,7999,2
3422,T,7964,0,0,0,0,7963,7963,1
3423,A,7999,7994,0,0,0,0,7994,5
3423,C,7965,0,7959,0,0,0,7959,6
3424,A,8000,8000,0,0,0,0,8000,0
3424,C,7934,0,7934,0,0,0,7934,0
3425,C,8000,1,7997,0,0,1,7997,3
3425,T,7929,0,0,0,0,7927,7927,2
3426,T,7928,0,1,0,0,7927,7927,1
3426,T,7997,0,0,0,0,7996,7996,1
3427,A,8000,8000,0,0,0,0,8000,0
3427,C,7930,0,7921,0,0,0,7921,9
3428,C,7930,0,7930,0,0,0,7930,0
3428,T,7999,1,0,0,0,7998,7998,1
3429,G,7937,0,1,7934,0,0,7934,3
3429,G,7987,0,0,7981,0,1,7981,6
3430,C,7943,0,7901,1,0,0,7901,42
3430,G,7992,0,0,7991,0,1,7991,1
3431,A,7992,7991,1,0,0,0,7991,1
3431,C,7944,0,7944,0,0,0,7944,0
3432,C,7945,0,7941,2,0,1,7941,4
3432,T,7985,0,0,0,0,7983,7983,2
3433,G,7945,2,1,7928,0,1,7928,17
3433,G,7981,0,0,7980,0,0,7980,1
3434,A,7964,7962,0,0,0,0,7962,2
3434,G,7950,0,0,7950,0,0,7950,0
3435,A,7952,7951,0,0,0,0,7951,1
3435,A,7975,7974,0,1,0,0,7974,1
3436,C,7951,0,7949,0,0,1,7949,2
3436,C,8000,0,8000,0,0,0,8000,0
3437,G,7962,1,0,7961,0,0,7961,1
3437,G,8001,1,0,8000,0,0,8000,1
3438,A,7998,7989,0,0,0,1,7989,9
3438,C,7961,0,7960,0,0,1,7960,1
3439,A,7998,7998,0,0,0,0,7998,0
3439,T,7961,1,1,0,0,7957,7957,4
3440,A,7999,7998,0,1,0,0,7998,1
3440,C,7964,0,7962,0,0,2,7962,2
3441,A,7964,7964,0,0,0,0,7964,0
3441,T,8000,0,0,0,0,8000,8000,0
3442,A,7999,7998,0,1,0,0,7998,1
3442,G,7965,0,0,7962,0,0,7962,3
3443,G,7966,0,0,7966,0,0,7966,0
3443,G,8000,0,0,8000,0,0,8000,0
3444,A,7965,7964,0,0,0,0,7964,1
3444,A,8001,7999,0,1,0,1,7999,2
3445,C,7965,0,7965,0,0,0,7965,0
3445,C,8001,0,7998,0,0,3,7998,3
3446,A,7936,7935,0,0,0,0,7935,1
3446,A,7965,7962,0,2,0,0,7962,3
3447,G,7941,2,0,7938,0,1,7938,3
3447,G,7983,1,0,7981,0,0,7981,2
3448,A,7982,7982,0,0,0,0,7982,0
3448,C,7942,0,7941,0,0,1,7941,1
3449,G,7945,1,0,7939,0,0,7939,6
3449,T,7999,0,0,0,0,7999,7999,0
3450,C,8000,0,8000,0,0,0,8000,0
3450,G,7955,1,0,7954,0,0,7954,1
3451,C,7941,0,7909,0,0,2,7909,32
3451,G,7997,1,0,7996,0,0,7996,1
3452,C,7949,0,7948,0,0,1,7948,1
3452,C,8000,0,8000,0,0,0,8000,0
3453,C,7947,1,7944,2,0,0,7944,3
3453,T,7996,0,2,0,0,7994,7994,2
3454,G,7946,1,2,7941,0,0,7941,5
3454,G,8000,1,0,7999,0,0,7999,1
3455,A,7999,7998,0,0,0,1,7998,1
3455,C,7956,1,7954,0,0,0,7954,2
3456,G,8000,0,0,8000,0,0,8000,0
3456,T,7953,0,0,0,0,7952,7952,1
3457,A,7994,7992,0,1,0,0,7992,2
3457,G,7964,0,0,7964,0,0,7964,0
3458,C,7964,0,7964,0,0,0,7964,0
3458,T,7989,0,0,0,0,7989,7989,0
3459,A,7983,7981,0,1,0,1,7981,2
3459,T,7963,0,1,0,0,7962,7962,1
3460,C,7964,1,7963,0,0,0,7963,1
3460,G,7990,0,0,7982,0,4,7982,8
3461,A,7962,7961,0,0,0,0,7961,1
3461,G,8000,0,0,7999,0,0,7999,1
3462,T,7962,0,0,0,0,7962,7962,0
3462,T,7994,0,0,2,0,7991,7991,3
3463,A,7962,7960,0,0,0,0,7960,2
3463,G,7997,0,0,7995,0,2,7995,2
3464,A,7961,7960,0,1,0,0,7960,1
3464,C,8000,0,7995,0,0,2,7995,5
3465,C,7991,1,7987,0,0,1,7987,4
3465,G,7963,0,0,7962,0,0,7962,1
3466,A,7932,7932,0,0,0,0,7932,0
3466,T,7998,0,1,0,0,7996,7996,2
3467,C,7931,1,7930,0,0,0,7930,1
3467,C,8000,0,8000,0,0,0,8000,0
3468,A,8000,7999,0,0,0,0,7999,1
3468,T,7912,0,1,0,0,7911,7911,1
3469,C,7898,0,7896,0,0,1,7896,2
3469,C,8000,0,7997,1,0,2,7997,3
3470,G,7900,1,0,7896,0,1,7896,4
3470,T,7985,0,0,0,0,7985,7985,0
3471,G,7964,0,0,7964,0,0,7964,0
3471,G,7998,0,0,7998,0,0,7998,0
3472,A,7997,7996,0,0,0,1,7996,1
3472,C,7965,0,7955,0,0,1,7955,10
3473,C,7960,1,7959,0,0,0,7959,1
3473,T,7996,0,0,2,0,7990,7990,6
3474,T,7961,0,0,1,0,7958,7958,3
3474,T,7992,0,0,0,0,7992,7992,0
3475,A,7997,7996,0,0,0,0,7996,1
3475,T,7964,1,0,0,0,7963,7963,1
3476,A,7962,7962,0,0,0,0,7962,0
3476,A,7997,7996,0,0,0,1,7996,1
3477,G,7964,1,0,7963,0,0,7963,1
3477,G,7999,1,0,7998,0,0,7998,1
3478,A,7961,7955,0,0,0,0,7955,6
3478,C,7997,0,7994,0,0,2,7994,3
3479,A,7964,7963,1,0,0,0,7963,1
3479,A,7996,7995,0,0,0,0,7995,1
3480,C,7960,0,7906,0,0,0,7906,54
3480,T,7973,0,0,0,0,7962,7962,11
3481,C,7948,0,7947,0,0,1,7947,1
3481,T,7983,0,0,0,0,7983,7983,0
3482,C,7945,0,7944,0,0,1,7944,1
3482,G,7998,0,0,7995,0,1,7995,3
3483,C,7956,0,7956,0,0,0,7956,0
3483,G,7999,0,0,7999,0,0,7999,0
3484,A,7961,7959,0,1,0,0,7959,2
3484,T,7995,0,0,0,0,7993,7993,2
3485,A,7991,7987,0,2,0,0,7987,4
3485,G,7964,0,0,7963,0,0,7963,1
3486,A,7977,7976,0,0,0,1,7976,1
3486,T,7965,0,0,0,0,7965,7965,0
3487,A,7966,7965,1,0,0,0,7965,1
3487,C,7997,0,7996,0,0,1,7996,1
3488,T,7964,0,0,0,0,7964,7964,0
3488,T,7995,0,1,0,0,7994,7994,1
3489,C,7956,0,7954,0,0,2,7954,2
3489,G,7999,0,0,7997,0,1,7997,2
3490,A,7955,7954,0,1,0,0,7954,1
3490,T,7993,0,0,0,0,7993,7993,0
3491,C,7996,0,7994,0,0,2,7994,2
3491,G,7963,0,0,7962,0,0,7962,1
3492,A,7993,7991,0,2,0,0,7991,2
3492,C,7963,0,7962,0,0,0,7962,1
3493,A,7946,7945,0,0,0,0,7945,1
3493,G,8000,0,0,8000,0,0,8000,0
3494,A,8001,8001,0,0,0,0,8001,0
3494,G,7948,0,0,7946,0,1,7946,2
3495,A,7946,7943,0,0,0,0,7943,3
3495,C,8002,2,7988,0,0,0,7988,14
3496,A,7944,7943,0,1,0,0,7943,1
3496,C,7991,1,7990,0,0,0,7990,1
3497,A,7996,7990,0,1,0,1,7990,6
3497,G,7958,0,0,7952,0,1,7952,6
3498,A,7999,7997,0,1,0,1,7997,2
3498,G,7954,0,0,7954,0,0,7954,0
3499,A,7958,7957,0,1,0,0,7957,1
3499,G,8000,2,1,7996,0,0,7996,4
3500,C,7960,0,7959,0,0,0,7959,1
3500,T,8001,1,1,2,0,7981,7981,20
3501,A,7959,7957,0,1,0,1,7957,2
3501,T,8002,1,0,0,0,8001,8001,1
3502,T,7964,0,0,1,0,7924,7924,40
3502,T,7997,1,0,0,0,7996,7996,1
3503,A,7999,7998,0,0,0,0,7998,1
3503,T,7961,0,0,0,0,7961,7961,0
3504,C,7999,0,7998,0,0,0,7998,1
3504,T,7962,0,0,0,0,7962,7962,0
3505,T,7962,0,1,0,0,7961,7961,1
3505,T,8001,1,0,0,0,7999,7999,2
3506,A,7954,7953,0,1,0,0,7953,1
3506,C,8001,1,8000,0,0,0,8000,1
3507,A,7986,7977,0,1,0,1,7977,9
3507,G,7963,0,0,7949,0,0,7949,14
3508,G,7963,1,0,7962,0,0,7962,1
3508,T,7991,0,0,0,0,7991,7991,0
3509,A,7955,7955,0,0,0,0,7955,0
3509,A,8000,7999,0,0,0,1,7999,1
3510,C,7956,1,7955,0,0,0,7955,1
3510,T,8000,1,0,0,0,7996,7996,4
3511,A,8001,7999,0,0,0,0,7999,2
3511,G,7947,1,0,7895,0,2,7895,52
3512,G,7964,0,0,7964,0,0,7964,0
3512,T,8001,0,0,0,0,8000,8000,1
3513,A,7991,7991,0,0,0,0,7991,0
3513,G,7964,0,0,7964,0,0,7964,0
3514,A,7965,7965,0,0,0,0,7965,0
3514,C,8000,0,7999,0,0,0,7999,1
3515,C,7966,0,7965,0,0,0,7965,1
3515,T,7941,0,0,1,0,7930,7930,11
3516,T,7943,0,0,0,0,7943,7943,0
3516,T,7962,0,0,0,0,7959,7959,3
3517,T,7941,0,0,0,0,7941,7941,0
3517,T,7961,0,0,0,0,7961,7961,0
3518,A,7938,7937,0,1,0,0,7937,1
3518,G,7964,0,0,7940,0,0,7940,24
3519,G,7944,0,0,7944,0,0,7944,0
3519,G,7965,2,0,7963,0,0,7963,2
3520,A,7941,7940,0,0,0,1,7940,1
3520,G,7966,1,0,7965,0,0,7965,1
3521,T,7938,0,0,0,0,7938,7938,0
3521,T,7941,1,0,0,0,7935,7935,6
3522,G,7939,1,0,7938,0,0,7938,1
3522,T,7920,0,1,0,0,7919,7919,1
3523,A,7962,7960,0,0,0,2,7960,2
3523,G,7934,1,0,7933,0,0,7933,1
3524,A,7963,7962,0,1,0,0,7962,1
3524,C,7964,0,7964,0,0,0,7964,0
3525,T,7963,0,0,0,0,7943,7943,20
3525,T,7964,0,0,0,0,7964,7964,0
3526,C,7964,1,7963,0,0,0,7963,1
3526,T,7963,0,0,0,0,7963,7963,0
3527,T,7963,0,1,0,0,7962,7962,1
3527,T,7966,0,0,0,0,7965,7965,1
3528,A,7960,7958,1,1,0,0,7958,2
3528,A,7965,7934,0,0,0,1,7934,31
3529,A,7966,7966,0,0,0,0,7966,0
3529,G,7960,0,0,7947,0,0,7947,13
3530,A,7966,7965,1,0,0,0,7965,1
3530,G,7960,0,0,7960,0,0,7960,0
3531,A,7969,7966,0,0,0,3,7966,3
3531,G,7964,0,0,7964,0,0,7964,0
3532,C,7950,0,7950,0,0,0,7950,0
3532,C,7977,1,7975,0,0,1,7975,2
3533,A,7862,7862,0,0,0,0,7862,0
3533,T,7964,0,1,0,0,7959,7959,5
3534,C,7871,1,7869,0,0,1,7869,2
3534,T,7963,1,0,1,0,7961,7961,2
3535,C,7965,0,7964,0,0,0,7964,1
3535,T,7867,0,0,0,0,7867,7867,0
3536,A,7964,7962,0,1,0,0,7962,2
3536,G,7883,0,0,7869,0,0,7869,14
3537,G,7888,0,0,7887,0,1,7887,1
3537,T,7965,3,0,0,0,7864,7864,101
3538,T,7887,0,0,0,0,7829,7829,58
3538,T,7967,0,0,0,0,7967,7967,0
3539,T,7889,0,1,0,0,7888,7888,1
3539,T,7967,0,0,0,0,7967,7967,0
3540,T,7887,0,0,0,0,7887,7887,0
3540,T,7966,0,0,0,0,7965,7965,1
3541,T,7912,0,2,0,0,7910,7910,2
3541,T,7965,2,0,0,0,7963,7963,2
3542,A,7966,7959,0,0,0,1,7959,7
3542,C,7913,1,7910,0,0,2,7910,3
3543,A,7988,7985,0,0,0,2,7985,3
3543,T,7921,0,0,0,0,7904,7904,17
3544,T,7922,0,1,0,0,7921,7921,1
3544,T,7989,0,0,0,0,7971,7971,18
3545,T,7919,0,2,0,0,7917,7917,2
3545,T,7990,0,0,0,0,7990,7990,0
3546,C,7927,0,7915,0,0,2,7915,12
3546,T,7991,1,0,0,0,7989,7989,2
3547,A,7992,7961,0,1,0,1,7961,31
3547,C,7927,1,7924,0,0,2,7924,3
3548,A,7928,7926,0,2,0,0,7926,2
3548,A,7993,7992,1,0,0,0,7992,1
3549,A,7993,7993,0,0,0,0,7993,0
3549,G,7928,0,0,7928,0,0,7928,0
3550,A,7922,7922,0,0,0,0,7922,0
3550,A,7993,7991,0,2,0,0,7991,2
3551,G,7941,0,0,7940,0,0,7940,1
3551,G,8000,0,0,7994,0,0,7994,6
3552,A,7932,7932,0,0,0,0,7932,0
3552,G,7999,0,0,7999,0,0,7999,0
3553,A,8000,7998,0,0,0,0,7998,2
3553,G,7941,0,1,7940,0,0,7940,1
3554,C,7943,1,7940,0,0,2,7940,3
3554,T,8001,0,0,0,0,8001,8001,0
3555,C,8002,2,7999,0,0,1,7999,3
3555,G,7940,1,0,7933,0,0,7933,7
3556,G,7964,0,0,7962,0,2,7962,2
3556,T,8002,0,0,0,0,8002,8002,0
3557,A,7965,7957,0,2,0,0,7957,8
3557,A,8003,8002,0,0,0,0,8002,1
3558,A,7965,7962,0,3,0,0,7962,3
3558,G,8004,0,0,8002,0,0,8002,2
3559,C,7964,0,7964,0,0,0,7964,0
3559,G,8005,1,0,8003,0,1,8003,2
3560,A,7958,7957,0,0,0,0,7957,1
3560,T,7996,0,1,0,0,7995,7995,1
3561,G,7964,0,0,7958,0,1,7958,6
3561,G,7990,1,0,7989,0,0,7989,1
3562,A,7990,7989,0,0,0,0,7989,1
3562,G,7962,1,1,7959,0,1,7959,3
3563,A,7990,7988,1,1,0,0,7988,2
3563,C,7960,0,7958,0,0,2,7958,2
3564,G,7960,0,0,7959,0,0,7959,1
3564,G,7999,2,0,7997,0,0,7997,2
3565,A,7947,7946,0,1,0,0,7946,1
3565,A,7999,7998,0,0,0,0,7998,1
3566,G,7947,1,0,7935,0,0,7935,12
3566,T,7997,1,0,0,0,7996,7996,1
3567,C,7998,0,7993,0,0,0,7993,5
3567,G,7964,0,0,7962,0,0,7962,2
3568,A,7962,7910,0,1,0,0,7910,52
3568,C,7998,0,7997,0,0,0,7997,1
3569,A,7965,7965,0,0,0,0,7965,0
3569,T,7998,1,1,0,0,7910,7910,88
3570,A,7964,7964,0,0,0,0,7964,0
3570,T,7998,0,0,0,0,7998,7998,0
3571,A,7963,7961,0,1,0,0,7961,2
3571,T,8000,0,0,0,0,8000,8000,0
3572,G,7963,2,0,7961,0,0,7961,2
3572,T,8001,0,0,0,0,8001,8001,0
3573,T,7963,0,0,0,0,7963,7963,0
3573,T,8001,0,0,0,0,8001,8001,0
3574,A,7958,7957,0,0,0,0,7957,1
3574,G,8002,0,0,8002,0,0,8002,0
3575,A,8003,8003,0,0,0,0,8003,0
3575,G,7964,1,0,7963,0,0,7963,1
3576,T,7961,0,0,0,0,7961,7961,0
3576,T,8001,0,0,0,0,8001,8001,0
3577,A,7997,7994,0,1,0,1,7994,3
3577,C,7962,0,7920,0,0,0,7920,42
3578,A,7998,7997,0,1,0,0,7997,1
3578,C,7955,0,7955,0,0,0,7955,0
3579,C,7960,0,7958,0,0,1,7958,2
3579,T,8000,0,0,0,0,8000,8000,0
3580,C,8001,0,8001,0,0,0,8001,0
3580,T,7960,1,0,0,0,7958,7958,2
3581,T,7962,0,1,0,0,7961,7961,1
3581,T,7999,0,0,0,0,7998,7998,1
3582,C,7964,1,7963,0,0,0,7963,1
3582,C,8000,0,7998,0,0,1,7998,2
3583,A,7998,7997,1,0,0,0,7997,1
3583,T,7963,1,0,0,0,7962,7962,1
3584,C,7964,0,7961,0,0,2,7961,3
3584,T,7999,1,0,0,0,7997,7997,2
3585,G,7963,0,0,7956,0,1,7956,7
3585,G,8000,0,0,8000,0,0,8000,0
3586,A,8001,8000,0,0,0,1,8000,1
3586,G,7964,0,0,7964,0,0,7964,0
3587,C,7964,0,7962,0,0,2,7962,2
3587,C,8002,1,7998,0,0,0,7998,4
3588,C,7999,0,7999,0,0,0,7999,0
3588,G,7949,0,0,7949,0,0,7949,0
3589,A,7964,7963,0,1,0,0,7963,1
3589,A,7993,7965,0,0,0,0,7965,28
3590,A,8000,8000,0,0,0,0,8000,0
3590,T,7964,0,0,0,0,7959,7959,5
3591,A,8001,7999,0,2,0,0,7999,2
3591,T,7964,0,1,0,0,7963,7963,1
3592,A,8002,8000,0,1,0,0,8000,2
3592,C,7965,0,7963,0,0,2,7963,2
3593,T,7962,0,0,0,0,7962,7962,0
3593,T,8001,1,0,0,0,8000,8000,1
3594,C,8003,0,7949,1,0,2,7949,54
3594,G,7964,0,0,7963,0,0,7963,1
3595,C,7965,1,7963,0,0,1,7963,2
3595,C,8003,0,8003,0,0,0,8003,0
3596,C,7998,1,7997,0,0,0,7997,1
3596,G,7966,2,1,7957,0,1,7957,9
3597,G,7965,1,0,7963,0,0,7963,2
3597,T,7999,0,0,0,0,7994,7994,5
3598,A,7960,7955,0,3,0,0,7955,5
3598,T,8000,0,0,0,0,8000,8000,0
3599,A,7998,7995,0,0,0,0,7995,3
3599,G,7964,2,0,7926,0,1,7926,38
3600,A,8000,8000,0,0,0,0,8000,0
3600,G,7964,0,0,7964,0,0,7964,0
3601,C,8001,0,8001,0,0,0,8001,0
3601,G,7962,1,0,7961,0,0,7961,1
3602,A,7964,7963,0,0,0,1,7963,1
3602,G,8001,1,0,7999,0,0,7999,2
3603,T,7963,0,0,1,0,7961,7961,2
3603,T,7980,1,0,0,0,7978,7978,2
3604,C,7964,0,7963,0,0,1,7963,1
3604,G,7984,2,0,7982,0,0,7982,2
3605,A,7984,7984,0,0,0,0,7984,0
3605,T,7964,0,1,0,0,7963,7963,1
3606,C,7965,1,7956,0,0,0,7956,9
3606,G,7993,0,0,7993,0,0,7993,0
3607,C,7960,0,7960,0,0,0,7960,0
3607,T,7992,0,0,0,0,7936,7936,56
3608,G,7956,0,0,7956,0,0,7956,0
3608,T,7990,0,1,0,0,7989,7989,1
3609,T,7952,0,0,1,0,7951,7951,1
3609,T,7990,0,0,0,0,7990,7990,0
3610,G,7944,0,0,7890,0,0,7890,54
3610,T,7999,0,1,0,0,7998,7998,1
3611,C,7999,0,7998,0,0,1,7998,1
3611,G,7948,1,0,7947,0,0,7947,1
3612,G,7946,0,0,7946,0,0,7946,0
3612,G,8000,0,0,7999,0,1,7999,1
3613,G,7957,1,2,7954,0,0,7954,3
3613,T,8001,0,2,0,0,7997,7997,4
3614,C,7951,0,7948,2,0,1,7948,3
3614,T,7999,0,0,0,0,7999,7999,0
3615,C,7999,0,7991,0,0,1,7991,8
3615,G,7951,4,0,7936,0,0,7936,15
3616,C,7997,0,7997,0,0,0,7997,0
3616,G,7957,1,0,7956,0,0,7956,1
3617,A,8000,7998,0,0,0,0,7998,2
3617,T,7955,0,0,1,0,7954,7954,1
3618,C,8001,0,8001,0,0,0,8001,0
3618,G,7956,0,0,7955,0,0,7955,1
3619,A,7954,7949,0,0,0,0,7949,5
3619,T,7988,0,0,0,0,7988,7988,0
3620,A,7953,7951,0,0,0,1,7951,2
3620,G,8000,0,0,8000,0,0,8000,0
3621,A,7999,7999,0,0,0,0,7999,0
3621,C,7960,0,7954,0,0,6,7954,6
3622,G,7963,2,0,7960,0,0,7960,3
3622,G,8000,0,0,7998,0,1,7998,2
3623,C,7964,0,7955,0,0,0,7955,9
3623,C,8000,0,7999,0,0,0,7999,1
3624,C,7960,0,7958,1,0,0,7958,2
3624,G,7998,0,0,7997,0,1,7997,1
3625,G,7962,1,0,7961,0,0,7961,1
3625,T,8000,0,2,0,0,7998,7998,2
3626,A,7964,7963,0,1,0,0,7963,1
3626,C,8000,0,7999,0,0,1,7999,1
3627,A,7999,7998,0,0,0,0,7998,1
3627,T,7964,0,0,0,0,7961,7961,3
3628,G,7965,0,0,7965,0,0,7965,0
3628,G,8000,1,0,7999,0,0,7999,1
3629,A,7966,7965,0,0,0,0,7965,1
3629,A,7992,7991,0,1,0,0,7991,1
3630,C,7999,0,7952,0,0,2,7952,47
3630,T,7966,1,0,0,0,7961,7961,5
3631,C,7960,0,7959,0,0,1,7959,1
3631,T,7968,0,0,0,0,7965,7965,3
3632,A,7963,7961,0,1,0,0,7961,2
3632,C,7995,0,7994,0,0,1,7994,1
3633,C,7985,1,7982,1,0,0,7982,3
3633,T,7965,0,0,0,0,7964,7964,1
3634,A,7965,7964,1,0,0,0,7964,1
3634,G,7998,0,1,7996,0,0,7996,2
3635,T,7966,1,0,0,0,7965,7965,1
3635,T,7999,0,0,0,0,7999,7999,0
3636,A,7956,7949,0,0,0,0,7949,7
3636,A,7999,7999,0,0,0,0,7999,0
3637,A,7943,7941,0,2,0,0,7941,2
3637,G,8001,0,0,7999,0,0,7999,2
3638,A,7999,7970,0,1,0,0,7970,29
3638,G,7940,0,0,7927,0,2,7927,13
3639,A,7998,7997,1,0,0,0,7997,1
3639,G,7906,0,0,7906,0,0,7906,0
3640,A,7905,7905,0,0,0,0,7905,0
3640,A,7998,7998,0,0,0,0,7998,0
3641,A,7988,7986,0,2,0,0,7986,2
3641,C,7870,1,7865,0,0,0,7865,5
3642,G,7868,1,0,7865,0,0,7865,3
3642,G,8000,0,0,8000,0,0,8000,0
3643,A,7996,7996,0,0,0,0,7996,0
3643,C,7892,0,7892,0,0,0,7892,0
3644,G,7892,2,0,7887,0,1,7887,5
3644,T,8000,0,0,0,0,7999,7999,1
3645,C,7892,0,7883,0,0,0,7883,9
3645,C,8000,0,7998,0,0,0,7998,2
3646,A,7998,7989,0,0,0,0,7989,9
3646,C,7892,0,7891,0,0,0,7891,1
3647,A,8000,7998,0,2,0,0,7998,2
3647,G,7922,0,0,7887,0,1,7887,35
3648,A,8001,8000,0,1,0,0,8000,1
3648,G,7922,0,0,7922,0,0,7922,0
3649,G,7963,0,0,7963,0,0,7963,0
3649,G,8002,0,1,7993,0,1,7993,9
3650,G,8002,1,0,8001,0,0,8001,1
3650,T,7960,0,1,1,0,7958,7958,2
3651,A,7989,7989,0,0,0,0,7989,0
3651,G,7962,1,0,7961,0,0,7961,1
3652,T,7957,0,2,1,0,7951,7951,6
3652,T,7988,0,1,0,0,7985,7985,3
3653,C,7998,1,7997,0,0,0,7997,1
3653,G,7964,1,0,7954,0,0,7954,10
3654,G,7965,1,1,7963,0,0,7963,2
3654,T,7999,1,2,0,0,7990,7990,9
3655,C,7965,0,7964,0,0,1,7964,1
3655,T,8000,0,0,0,0,8000,8000,0
3656,A,7951,7950,0,0,0,0,7950,1
3656,C,8001,0,8001,0,0,0,8001,0
3657,C,7956,1,7955,0,0,0,7955,1
3657,T,8001,0,0,0,0,7993,7993,8
3658,A,7952,7951,0,0,0,0,7951,1
3658,T,8001,0,0,0,0,8001,8001,0
3659,G,7964,0,1,7962,0,1,7962,2
3659,G,8002,0,0,8002,0,0,8002,0
3660,A,7997,7996,0,0,0,0,7996,1
3660,C,7963,0,7960,1,0,1,7960,3
3661,G,7998,0,0,7997,0,1,7997,1
3661,T,7963,0,0,0,0,7963,7963,0
3662,A,7958,7957,0,0,0,1,7957,1
3662,A,7994,7994,0,0,0,0,7994,0
3663,G,7961,0,0,7959,0,1,7959,2
3663,T,7996,0,1,0,0,7995,7995,1
3664,C,7998,0,7992,0,0,2,7992,6
3664,T,7961,2,0,0,0,7958,7958,3
3665,C,7995,0,7989,0,0,2,7989,6
3665,T,7961,0,1,0,0,7960,7960,1
3666,C,7959,0,7956,0,0,1,7956,3
3666,T,7993,0,1,0,0,7733,7733,260
3667,C,7936,1,7933,0,0,2,7933,3
3667,T,7995,1,1,0,0,7993,7993,2
3668,G,7935,1,0,7934,0,0,7934,1
3668,T,7998,0,0,0,0,7998,7998,0
3669,T,7936,0,0,0,0,7934,7934,2
3669,T,8000,0,0,0,0,8000,8000,0
3670,C,7937,0,7935,0,0,1,7935,2
3670,T,8000,0,0,0,0,8000,8000,0
3671,G,7935,1,0,7934,0,0,7934,1
3671,T,8000,0,0,0,0,8000,8000,0
3672,C,7935,0,7934,0,0,1,7934,1
3672,T,7997,0,1,0,0,7995,7995,2
3673,A,7933,7931,0,2,0,0,7931,2
3673,C,7995,0,7994,0,0,0,7994,1
3674,G,7939,1,0,7938,0,0,7938,1
3674,T,7989,0,1,0,0,7987,7987,2
3675,C,7939,0,7933,0,0,1,7933,6
3675,G,8000,0,0,7999,0,0,7999,1
3676,C,7941,0,7937,0,0,2,7937,4
3676,C,8000,1,7996,0,0,2,7996,4
3677,G,7939,2,1,7879,0,0,7879,60
3677,G,8001,0,0,8001,0,0,8001,0
3678,C,8002,1,7998,0,0,0,7998,4
3678,G,7956,0,0,7956,0,0,7956,0
3679,G,7964,0,0,7964,0,0,7964,0
3679,G,8002,0,0,8002,0,0,8002,0
3680,A,7965,7965,0,0,0,0,7965,0
3680,T,8003,0,0,0,0,8003,8003,0
3681,A,8004,7995,0,0,0,0,7995,9
3681,T,7965,0,0,0,0,7955,7955,10
3682,A,8005,8004,0,0,0,1,8004,1
3682,T,7965,0,0,0,0,7965,7965,0
3683,T,7964,0,2,0,0,7962,7962,2
3683,T,8006,0,0,0,0,8005,8005,1
3684,C,8006,0,8004,0,0,2,8004,2
3684,G,7964,1,0,7950,0,0,7950,14
3685,G,7964,0,0,7964,0,0,7964,0
3685,T,7996,0,0,0,0,7996,7996,0
3686,G,7964,0,0,7964,0,0,7964,0
3686,G,7999,3,0,7996,0,0,7996,3
3687,C,8000,1,7998,0,0,1,7998,2
3687,T,7961,0,0,0,0,7961,7961,0
3688,C,7959,0,7959,0,0,0,7959,0
3688,T,7994,0,1,0,0,7993,7993,1
3689,G,7959,0,0,7957,0,1,7957,2
3689,G,7999,1,0,7998,0,0,7998,1
3690,C,7964,1,7961,0,0,1,7961,3
3690,C,7995,0,7994,0,0,1,7994,1
3691,G,7964,1,0,7953,0,1,7953,11
3691,T,7992,0,1,0,0,7988,7988,4
3692,G,7965,0,0,7965,0,0,7965,0
3692,T,7992,0,0,0,0,7992,7992,0
3693,G,7992,0,0,7992,0,0,7992,0
3693,T,7965,0,0,0,0,7958,7958,7
3694,C,7993,1,7991,0,0,0,7991,2
3694,T,7966,0,0,0,0,7965,7965,1
3695,A,7991,7966,0,1,0,0,7966,25
3695,C,7966,1,7964,0,0,1,7964,2
3696,A,7991,7991,0,0,0,0,7991,0
3696,T,7968,0,0,0,0,7960,7960,8
3697,A,7992,7992,0,0,0,0,7992,0
3697,T,7969,0,1,0,0,7968,7968,1
3698,C,7998,3,7995,0,0,0,7995,3
3698,G,7970,1,0,7969,0,0,7969,1
3699,A,7996,7785,4,0,0,0,7785,211
3699,T,7969,0,0,0,0,7948,7948,21
3700,A,7994,7994,0,0,0,0,7994,0
3700,T,7970,0,0,0,0,7970,7970,0
3701,A,7999,7997,0,2,0,0,7997,2
3701,T,7954,0,1,0,0,7953,7953,1
3702,A,7999,7997,1,0,0,1,7997,2
3702,G,7957,1,0,7955,0,0,7955,2
3703,A,8000,7999,0,1,0,0,7999,1
3703,T,7955,0,0,0,0,7955,7955,0
3704,A,8001,8001,0,0,0,0,8001,0
3704,G,7961,0,0,7957,0,0,7957,4
3705,A,8001,7996,3,0,0,0,7996,5
3705,G,7962,2,0,7960,0,0,7960,2
3706,A,7958,7957,0,1,0,0,7957,1
3706,C,8000,1,7981,0,0,0,7981,19
3707,C,8001,0,7999,0,0,1,7999,2
3707,T,7960,0,0,0,0,7960,7960,0
3708,A,8000,8000,0,0,0,0,8000,0
3708,C,7960,0,7959,0,0,1,7959,1
3709,C,8001,0,7993,0,0,2,7993,8
3709,G,7964,3,0,7961,0,0,7961,3
3710,C,7965,0,7964,0,0,1,7964,1
3710,C,8002,0,8001,0,0,1,8001,1
3711,G,8003,2,0,8000,0,0,8000,3
3711,T,7962,0,0,0,0,7962,7962,0
3712,C,8005,0,8004,0,0,0,8004,1
3712,G,7964,1,0,7963,0,0,7963,1
3713,T,7962,0,0,0,0,7961,7961,1
3713,T,8006,0,0,0,0,8006,8006,0
3714,A,8007,8004,1,1,0,0,8004,3
3714,G,7963,1,0,7961,0,1,7961,2
3715,A,7964,7964,0,0,0,0,7964,0
3715,C,8007,0,8001,0,0,0,8001,6
3716,C,8008,1,8007,0,0,0,8007,1
3716,T,7961,0,0,0,0,7960,7960,1
3717,A,8008,8005,0,2,0,0,8005,3
3717,C,7960,1,7957,0,0,2,7957,3
3718,G,7962,0,0,7962,0,0,7962,0
3718,G,8006,0,1,8001,0,1,8001,5
3719,C,8006,0,8003,1,0,2,8003,3
3719,T,7959,0,0,0,0,7959,7959,0
3720,C,7964,0,7964,0,0,0,7964,0
3720,G,8007,1,0,8004,0,0,8004,3
3721,A,7959,7958,0,0,0,0,7958,1
3721,G,8006,0,0,8005,0,1,8005,1
3722,C,7964,0,7964,0,0,0,7964,0
3722,T,8005,0,0,0,0,8005,8005,0
3723,G,8005,1,0,7998,0,0,7998,7
3723,T,7962,0,1,0,0,7960,7960,2
3724,G,8006,1,0,8005,0,0,8005,1
3724,T,7960,0,0,0,0,7960,7960,0
3725,G,7964,0,0,7960,0,0,7960,4
3725,T,8003,0,0,0,0,7970,7970,33
3726,G,7964,0,0,7964,0,0,7964,0
3726,T,8004,0,0,0,0,8004,8004,0
3727,T,7963,0,1,2,0,7960,7960,3
3727,T,8003,0,3,0,0,8000,8000,3
3728,G,7963,0,0,7963,0,0,7963,0
3728,G,8004,0,0,8003,0,0,8003,1
3729,A,7955,7954,0,1,0,0,7954,1
3729,T,8004,0,0,0,0,7991,7991,13
3730,G,7964,1,0,7962,0,0,7962,2
3730,T,8001,0,1,1,0,7999,7999,2
3731,T,7963,0,2,0,0,7961,7961,2
3731,T,7999,0,0,0,0,7999,7999,0
3732,A,7960,7960,0,0,0,0,7960,0
3732,G,7994,0,0,7994,0,0,7994,0
3733,C,7994,0,7989,0,0,0,7989,5
3733,G,7963,2,0,7959,0,1,7959,4
3734,C,7952,1,7948,1,0,0,7948,4
3734,C,7994,1,7991,0,0,2,7991,3
3735,G,7961,0,0,7912,0,0,7912,49
3735,G,7992,0,0,7986,0,1,7986,6
3736,G,7964,0,0,7964,0,0,7964,0
3736,G,8000,0,0,8000,0,0,8000,0
3737,A,8000,8000,0,0,0,0,8000,0
3737,G,7957,0,2,7954,0,0,7954,3
3738,C,7962,0,7959,0,0,2,7959,3
3738,T,8000,0,0,0,0,8000,8000,0
3739,C,7999,0,7998,0,0,1,7998,1
3739,T,7950,1,0,0,0,7949,7949,1
3740,A,7998,7996,0,0,0,0,7996,2
3740,G,7959,0,0,7958,0,0,7958,1
3741,A,7997,7995,0,0,0,0,7995,2
3741,C,7958,0,7953,0,0,3,7953,5
3742,G,7998,2,0,7996,0,0,7996,2
3742,T,7956,0,2,1,0,7953,7953,3
3743,A,8001,8000,0,1,0,0,8000,1
3743,G,7964,0,0,7940,0,1,7940,24
3744,G,7963,0,0,7963,0,0,7963,0
3744,G,8002,1,0,8000,0,0,8000,2
3745,C,7984,0,7983,0,0,0,7983,1
3745,G,7962,1,1,7960,0,0,7960,2
3746,C,7962,0,7962,0,0,0,7962,0
3746,T,7986,0,0,0,0,7986,7986,0
3747,A,7999,7999,0,0,0,0,7999,0
3747,T,7944,2,0,0,0,7942,7942,2
3748,C,8000,0,7994,0,0,0,7994,6
3748,G,7960,2,0,7952,0,1,7952,8
3749,C,8001,0,8001,0,0,0,8001,0
3749,G,7958,4,0,7953,0,0,7953,5
3750,A,8002,7994,0,0,0,0,7994,8
3750,C,7957,1,7942,0,0,2,7942,15
3751,A,7999,7996,2,0,0,1,7996,3
3751,C,7957,0,7955,0,0,0,7955,2
3752,C,8000,1,7998,0,0,0,7998,2
3752,G,7955,0,2,7853,0,1,7853,102
3753,G,7964,1,0,7963,0,0,7963,1
3753,T,7998,0,1,0,0,7997,7997,1
3754,C,7998,0,7995,0,0,0,7995,3
3754,G,7965,1,0,7964,0,0,7964,1
3755,G,7966,0,1,7965,0,0,7965,1
3755,T,7995,0,1,0,0,7880,7880,115
3756,C,7967,0,7965,0,0,2,7965,2
3756,T,7993,1,0,1,0,7991,7991,2
3757,T,7963,0,0,0,0,7933,7933,30
3757,T,7995,0,0,0,0,7995,7995,0
3758,T,7962,0,0,0,0,7962,7962,0
3758,T,7999,0,0,0,0,7999,7999,0
3759,T,7962,1,2,0,0,7958,7958,4
3759,T,8000,0,0,0,0,8000,8000,0
3760,C,7961,0,7960,0,0,1,7960,1
3760,C,8001,0,7985,0,0,0,7985,16
3761,C,7994,0,7992,0,0,1,7992,2
3761,G,7962,2,0,7959,0,0,7959,3
3762,G,7998,1,0,7997,0,0,7997,1
3762,T,7959,1,0,0,0,7955,7955,4
3763,A,7998,7991,0,2,0,0,7991,7
3763,G,7958,0,0,7950,0,0,7950,8
3764,A,7999,7998,0,1,0,0,7998,1
3764,G,7960,1,0,7958,0,0,7958,2
3765,C,7963,0,7953,2,0,4,7953,10
3765,G,8001,0,0,8000,0,0,8000,1
3766,C,7963,1,7959,1,0,0,7959,4
3766,G,8002,0,0,8002,0,0,8002,0
3767,G,7955,2,0,7952,0,0,7952,3
3767,T,7999,0,0,0,0,7998,7998,1
3768,A,7998,7994,0,0,0,0,7994,4
3768,C,7957,1,7953,1,0,0,7953,4
3769,A,8000,8000,0,0,0,0,8000,0
3769,C,7957,0,7952,1,0,1,7952,5
3770,C,8000,0,7995,0,0,5,7995,5
3770,G,7959,2,1,7876,0,1,7876,83
3771,G,7964,1,0,7961,0,2,7961,3
3771,T,7999,0,1,0,0,7998,7998,1
3772,G,7965,0,0,7964,0,0,7964,1
3772,G,8000,0,0,7984,0,0,7984,16
3773,C,7965,0,7955,0,0,1,7955,10
3773,G,7998,1,0,7996,0,1,7996,2
3774,C,7960,0,7960,0,0,0,7960,0
3774,C,8000,1,7998,0,0,1,7998,2
3775,G,7963,4,0,7959,0,0,7959,4
3775,T,7996,0,1,0,0,7995,7995,1
3776,C,7963,0,7963,0,0,0,7963,0
3776,T,7994,0,0,0,0,7994,7994,0
3777,C,8000,0,7999,0,0,1,7999,1
3777,T,7963,0,1,0,0,7961,7961,2
3778,A,7999,7999,0,0,0,0,7999,0
3778,C,7963,0,7962,0,0,1,7962,1
3779,G,7962,1,0,7954,0,0,7954,8
3779,G,8000,1,0,7999,0,0,7999,1
3780,C,8001,0,8000,0,0,1,8000,1
3780,G,7962,0,0,7962,0,0,7962,0
3781,A,7992,7989,0,1,0,0,7989,3
3781,T,7963,1,0,2,0,7959,7959,4
3782,G,7962,0,0,7931,0,4,7931,31
3782,G,8000,0,0,8000,0,0,8000,0
3783,A,7989,7988,0,0,0,0,7988,1
3783,G,7963,1,0,7960,0,2,7960,3
3784,G,7833,0,0,7833,0,0,7833,0
3784,G,8000,2,0,7996,0,0,7996,4
3785,A,7840,7834,1,2,0,0,7834,6
3785,C,8000,0,8000,0,0,0,8000,0
3786,C,7840,1,7838,0,0,0,7838,2
3786,G,7999,2,0,7996,0,0,7996,3
3787,C,7999,0,7999,0,0,0,7999,0
3787,G,7836,0,0,7831,0,0,7831,5
3788,A,7990,7989,0,0,0,0,7989,1
3788,G,7842,1,0,7841,0,0,7841,1
3789,A,7835,7828,0,1,0,0,7828,7
3789,G,7999,1,0,7998,0,0,7998,1
3790,A,7843,7842,0,0,0,1,7842,1
3790,A,8001,8000,0,0,0,0,8000,1
3791,G,7853,0,0,7851,0,0,7851,2
3791,T,8002,0,0,0,0,8002,8002,0
3792,A,8002,8001,1,0,0,0,8001,1
3792,C,7955,0,7952,0,0,2,7952,3
3793,C,8000,0,7987,0,0,1,7987,13
3793,G,7962,5,0,7953,0,1,7953,9
3794,C,7998,0,7998,0,0,0,7998,0
3794,T,7959,0,1,2,0,7954,7954,5
3795,A,7999,7984,0,0,0,0,7984,15
3795,G,7964,1,0,7962,0,0,7962,2
3796,A,7997,7996,0,0,0,1,7996,1
3796,T,7965,1,1,0,0,7963,7963,2
3797,A,8000,7999,0,0,0,1,7999,1
3797,G,7961,1,0,7946,0,0,7946,15
3798,G,7960,0,0,7959,0,0,7959,1
3798,T,7996,0,0,0,0,7996,7996,0
3799,A,7956,7954,0,0,0,0,7954,2
3799,A,7985,7985,0,0,0,0,7985,0
3800,C,8000,0,8000,0,0,0,8000,0
3800,G,7963,0,0,7961,0,0,7961,2
3801,A,7923,7922,0,1,0,0,7922,1
3801,T,7949,0,1,0,0,7948,7948,1
3802,G,7928,0,0,7927,0,0,7927,1
3802,G,8000,0,0,8000,0,0,8000,0
3803,A,7925,7922,0,1,0,0,7922,3
3803,T,7996,0,0,0,0,7992,7992,4
3804,C,7949,1,7942,0,0,1,7942,7
3804,T,7994,0,0,0,0,7994,7994,0
3805,C,7947,0,7945,1,0,1,7945,2
3805,C,7998,0,7998,0,0,0,7998,0
3806,G,7962,0,1,7961,0,0,7961,1
3806,T,7990,0,0,0,0,7990,7990,0
3807,C,7963,0,7958,0,0,0,7958,5
3807,T,7994,0,0,0,0,7994,7994,0
3808,C,7964,0,7964,0,0,0,7964,0
3808,C,7995,1,7994,0,0,0,7994,1
3809,A,7963,7959,0,1,0,0,7959,4
3809,T,7991,0,0,0,0,7991,7991,0
3810,A,7963,7962,0,0,0,0,7962,1
3810,A,8000,7997,0,1,0,0,7997,3
3811,G,7963,0,0,7929,0,1,7929,34
3811,G,8000,1,0,7999,0,0,7999,1
3812,G,7962,0,0,7961,0,0,7961,1
3812,T,7986,0,0,0,0,7985,7985,1
3813,G,7958,0,0,7958,0,0,7958,0
3813,G,7989,1,0,7988,0,0,7988,1
3814,C,7961,1,7960,0,0,0,7960,1
3814,T,7976,0,1,0,0,7975,7975,1
3815,A,7975,7973,0,0,0,0,7973,2
3815,T,7946,0,1,0,0,7944,7944,2
3816,G,7963,0,0,7963,0,0,7963,0
3816,G,7999,2,0,7997,0,0,7997,2
3817,C,8000,0,7994,0,0,0,7994,6
3817,T,7964,0,0,0,0,7964,7964,0
3818,A,7966,7965,0,1,0,0,7965,1
3818,C,7999,1,7998,0,0,0,7998,1
3819,G,7967,0,0,7967,0,0,7967,0
3819,G,7998,0,0,7998,0,0,7998,0
3820,T,7947,0,0,0,0,7947,7947,0
3820,T,7994,0,0,0,0,7992,7992,2
3821,A,7996,7996,0,0,0,0,7996,0
3821,C,7946,0,7944,0,0,2,7944,2
3822,G,7999,0,1,7997,0,1,7997,2
3822,T,7928,0,0,0,0,7928,7928,0
3823,G,7932,0,0,7909,0,0,7909,23
3823,T,7999,0,0,0,0,7996,7996,3
3824,G,7933,1,0,7932,0,0,7932,1
3824,T,7999,0,1,0,0,7998,7998,1
3825,A,7980,7980,0,0,0,0,7980,0
3825,G,7936,0,0,7936,0,0,7936,0
3826,G,7998,0,0,7996,0,0,7996,2
3826,T,7924,0,1,0,0,7922,7922,2
3827,C,7925,0,7912,0,0,0,7912,13
3827,G,8000,1,0,7999,0,0,7999,1
3828,C,7902,1,7900,1,0,0,7900,2
3828,C,7997,1,7981,0,0,0,7981,16
3829,C,7995,0,7994,0,0,1,7994,1
3829,G,7903,1,0,7901,0,0,7901,2
3830,A,7983,7982,0,0,0,0,7982,1
3830,C,7904,1,7901,0,0,2,7901,3
3831,C,7995,0,7993,0,0,0,7993,2
3831,G,7943,0,0,7943,0,0,7943,0
3832,A,7946,7946,0,0,0,0,7946,0
3832,C,7999,0,7998,0,0,1,7998,1
3833,A,8000,7998,0,0,0,0,7998,2
3833,G,7946,0,0,7946,0,0,7946,0
3834,C,7946,0,7946,0,0,0,7946,0
3834,C,8001,1,8000,0,0,0,8000,1
3835,A,7944,7942,1,0,0,0,7942,2
3835,T,7996,0,0,0,0,7995,7995,1
3836,A,7964,7959,1,2,0,2,7959,5
3836,T,7997,0,0,0,0,7997,7997,0
3837,C,8000,0,7999,0,0,1,7999,1
3837,G,7964,0,0,7960,0,0,7960,4
3838,A,7999,7996,0,0,0,0,7996,3
3838,G,7965,0,0,7965,0,0,7965,0
3839,A,8000,8000,0,0,0,0,8000,0
3839,T,7962,0,1,0,0,7951,7951,11
3840,G,8001,0,0,8001,0,0,8001,0
3840,T,7953,1,0,0,0,7952,7952,1
3841,A,7997,7995,0,0,0,0,7995,2
3841,G,7964,0,0,7962,0,1,7962,2
3842,A,7997,7997,0,0,0,0,7997,0
3842,C,7965,0,7952,0,0,1,7952,13
3843,C,7966,0,7966,0,0,0,7966,0
3843,C,7991,0,7990,0,0,0,7990,1
3844,C,7966,1,7965,0,0,0,7965,1
3844,T,7961,1,0,0,0,7959,7959,2
3845,C,8000,0,8000,0,0,0,8000,0
3845,T,7954,1,0,0,0,7953,7953,1
3846,G,7964,2,0,7962,0,0,7962,2
3846,T,7995,0,0,0,0,7995,7995,0
3847,A,7962,7956,0,0,0,0,7956,6
3847,G,8000,2,0,7997,0,1,7997,3
3848,A,7964,7962,2,0,0,0,7962,2
3848,T,8001,0,0,0,0,8001,8001,0
3849,A,7997,7997,0,0,0,0,7997,0
3849,C,7965,0,7965,0,0,0,7965,0
3850,G,8000,0,0,8000,0,0,8000,0
3850,T,7941,0,2,0,0,7939,7939,2
3851,C,7995,0,7991,0,0,2,7991,4
3851,G,7948,1,0,7827,0,1,7827,121
3852,A,7978,7976,2,0,0,0,7976,2
3852,G,7948,0,0,7948,0,0,7948,0
3853,C,7999,0,7994,1,0,0,7994,5
3853,G,7964,0,0,7964,0,0,7964,0
3854,C,7932,0,7932,0,0,0,7932,0
3854,G,7965,1,0,7964,0,0,7964,1
3855,G,7946,0,0,7941,0,3,7941,5
3855,G,7979,0,0,7979,0,0,7979,0
3856,C,7996,0,7990,0,0,0,7990,6
3856,T,7938,0,0,3,0,7925,7925,13
3857,C,8000,1,7999,0,0,0,7999,1
3857,T,7940,0,0,3,0,7934,7934,6
3858,G,7953,0,0,7593,0,3,7593,360
3858,T,7999,0,0,0,0,7999,7999,0
3859,A,7999,7999,0,0,0,0,7999,0
3859,G,7957,2,0,7954,0,1,7954,3
3860,C,8000,1,7998,0,0,1,7998,2
3860,G,7963,1,0,7962,0,0,7962,1
3861,A,8001,8000,0,0,0,0,8000,1
3861,G,7962,0,0,7962,0,0,7962,0
3862,G,7942,0,0,7939,0,1,7939,3
3862,T,8000,0,0,0,0,8000,8000,0
3863,A,7995,7995,0,0,0,0,7995,0
3863,G,7945,3,0,7942,0,0,7942,3
3864,A,7929,7923,0,6,0,0,7923,6
3864,C,7993,0,7988,0,0,0,7988,5
3865,C,7923,0,7923,0,0,0,7923,0
3865,G,7945,2,1,7941,0,0,7941,4
3866,C,7945,0,7944,0,0,1,7944,1
3866,T,7933,0,0,0,0,7932,7932,1
3867,C,7937,0,7936,1,0,0,7936,1
3867,G,7944,0,0,7944,0,0,7944,0
3868,C,7957,1,7955,0,0,0,7955,2
3868,G,7932,3,0,7929,0,0,7929,3
3869,A,7954,7954,0,0,0,0,7954,0
3869,C,7933,0,7933,0,0,0,7933,0
3870,G,7964,0,0,7964,0,0,7964,0
3870,T,7932,0,0,0,0,7932,7932,0
3871,C,7964,0,7964,0,0,0,7964,0
3871,C,7998,0,7997,0,0,0,7997,1
3872,A,7965,7912,0,3,0,0,7912,53
3872,T,7994,0,0,0,0,7993,7993,1
3873,A,7966,7966,0,0,0,0,7966,0
3873,G,7997,1,0,7996,0,0,7996,1
3874,A,7963,7963,0,0,0,0,7963,0
3874,C,7999,1,7997,0,0,1,7997,2
3875,A,7964,7963,1,0,0,0,7963,1
3875,T,7994,1,1,0,0,7992,7992,2
3876,A,7995,7987,0,0,0,0,7987,8
3876,T,7965,0,0,1,0,7962,7962,3
3877,A,7995,7993,0,1,0,0,7993,2
3877,G,7953,0,0,7951,0,0,7951,2
3878,G,7953,0,0,7952,0,0,7952,1
3878,T,7997,0,0,0,0,7997,7997,0
3879,C,7943,0,7941,0,0,2,7941,2
3879,C,8000,0,7991,0,0,1,7991,9
3880,C,7984,0,7984,0,0,0,7984,0
3880,G,7946,0,0,7940,0,0,7940,6
3881,G,7946,0,0,7946,0,0,7946,0
3881,T,7971,3,0,1,0,7966,7966,5
3882,C,7949,0,7947,0,0,2,7947,2
3882,G,7994,0,0,7993,0,1,7993,1
3883,T,7946,0,1,0,0,7945,7945,1
3883,T,7987,0,0,0,0,7986,7986,1
3884,G,7965,1,0,7964,0,0,7964,1
3884,T,7992,1,0,0,0,7991,7991,1
3885,A,8000,8000,0,0,0,0,8000,0
3885,T,7962,0,0,1,0,7960,7960,2
3886,C,7999,0,7993,0,0,0,7993,6
3886,T,7965,0,0,0,0,7964,7964,1
3887,C,7965,0,7915,0,0,3,7915,50
3887,C,7997,1,7996,0,0,0,7996,1
3888,A,7983,7981,1,1,0,0,7981,2
3888,C,7965,0,7965,0,0,0,7965,0
3889,C,7966,0,7962,0,0,4,7962,4
3889,G,7985,0,0,7983,0,0,7983,2
3890,G,7966,1,0,7965,0,0,7965,1
3890,T,7982,1,0,0,0,7980,7980,2
3891,A,7966,7966,0,0,0,0,7966,0
3891,G,7993,0,0,7984,0,0,7984,9
3892,G,7967,0,0,7967,0,0,7967,0
3892,G,8000,0,0,7999,0,0,7999,1
3893,C,7999,0,7997,0,0,0,7997,2
3893,T,7958,1,0,0,0,7957,7957,1
3894,C,7965,0,7965,0,0,0,7965,0
3894,T,7997,0,2,0,0,7995,7995,2
3895,G,7998,2,0,7996,0,0,7996,2
3895,T,7962,0,0,1,0,7954,7954,8
3896,C,7997,0,7996,0,0,1,7996,1
3896,T,7962,2,3,0,0,7957,7957,5
3897,G,7965,1,0,7964,0,0,7964,1
3897,T,7999,0,0,0,0,7999,7999,0
3898,A,7965,7964,0,0,0,0,7964,1
3898,G,8000,0,0,7999,0,0,7999,1
3899,A,7966,7965,0,0,0,0,7965,1
3899,C,7995,0,7977,0,0,1,7977,18
3900,C,8000,0,8000,0,0,0,8000,0
3900,T,7965,1,1,0,0,7960,7960,5
3901,A,7995,7995,0,0,0,0,7995,0
3901,G,7951,1,0,7945,0,0,7945,6
3902,G,7965,0,0,7965,0,0,7965,0
3902,G,7998,1,0,7996,0,0,7996,2
3903,A,7962,7956,1,1,0,0,7956,6
3903,T,7998,0,0,0,0,7998,7998,0
3904,A,7963,7963,0,0,0,0,7963,0
3904,G,7999,3,0,7989,0,0,7989,10
3905,G,7964,1,0,7963,0,0,7963,1
3905,G,7999,0,0,7998,0,1,7998,1
3906,A,7962,7958,1,1,0,0,7958,4
3906,C,7997,2,7994,1,0,0,7994,3
3907,C,7964,0,7963,0,0,1,7963,1
3907,G,8000,2,0,7998,0,0,7998,2
3908,A,8000,7998,0,0,0,0,7998,2
3908,G,7963,2,0,7959,0,2,7959,4
3909,C,7965,0,7964,0,0,1,7964,1
3909,T,8001,0,0,0,0,8001,8001,0
3910,A,8002,8000,0,0,0,0,8000,2
3910,T,7961,0,0,0,0,7959,7959,2
3911,A,8001,8000,0,0,0,1,8000,1
3911,T,7955,0,0,1,0,7954,7954,1
3912,G,7957,0,0,7957,0,0,7957,0
3912,G,8002,0,0,8002,0,0,8002,0
3913,T,7956,0,1,0,0,7954,7954,2
3913,T,7998,0,0,0,0,7998,7998,0
3914,C,7990,0,7990,0,0,0,7990,0
3914,G,7965,0,0,7965,0,0,7965,0
3915,A,7959,7955,0,1,0,0,7955,4
3915,G,7999,2,0,7995,0,1,7995,4
3916,G,7951,2,0,7944,0,0,7944,7
3916,T,7996,0,0,0,0,7995,7995,1
3917,G,7950,4,0,7945,0,0,7945,5
3917,G,8000,0,0,8000,0,0,8000,0
3918,C,7928,0,7925,2,0,1,7925,3
3918,T,8001,0,1,0,0,8000,8000,1
3919,C,8001,1,8000,0,0,0,8000,1
3919,G,7933,0,1,7906,0,0,7906,27
3920,G,7947,0,0,7947,0,0,7947,0
3920,T,8002,0,1,0,0,7997,7997,5
3921,G,7963,0,0,7962,0,1,7962,1
3921,T,7991,0,2,0,0,7989,7989,2
3922,A,7994,7994,0,0,0,0,7994,0
3922,C,7964,0,7964,0,0,0,7964,0
3923,C,7994,0,7988,0,0,1,7988,6
3923,T,7962,0,0,0,0,7962,7962,0
3924,C,7989,0,7988,1,0,0,7988,1
3924,G,7964,3,0,7961,0,0,7961,3
3925,G,7997,0,0,7955,0,0,7955,42
3925,T,7963,0,2,0,0,7961,7961,2
3926,G,7963,1,0,7962,0,0,7962,1
3926,G,7989,0,0,7987,0,2,7987,2
3927,A,7963,7963,0,0,0,0,7963,0
3927,G,7998,1,0,7995,0,2,7995,3
3928,G,7959,0,0,7954,0,0,7954,5
3928,T,7998,0,0,0,0,7992,7992,6
3929,G,7959,1,0,7958,0,0,7958,1
3929,T,7990,0,0,0,0,7990,7990,0
3930,G,7996,0,0,7989,0,1,7989,7
3930,T,7954,0,0,0,0,7954,7954,0
3931,C,7958,0,7958,0,0,0,7958,0
3931,G,7998,0,0,7998,0,0,7998,0
3932,A,7998,7998,0,0,0,0,7998,0
3932,G,7964,1,0,7963,0,0,7963,1
3933,C,7999,0,7999,0,0,0,7999,0
3933,T,7962,1,1,1,0,7951,7951,11
3934,T,7961,0,0,1,0,7960,7960,1
3934,T,7993,0,0,0,0,7993,7993,0
3935,C,7996,0,7994,0,0,1,7994,2
3935,G,7964,2,0,7962,0,0,7962,2
3936,A,7965,7953,0,0,0,0,7953,12
3936,A,7994,7986,0,0,0,0,7986,8
3937,A,7964,7964,0,0,0,0,7964,0
3937,A,7999,7996,0,2,0,1,7996,3
3938,A,7961,7961,0,0,0,0,7961,0
3938,G,8000,0,0,7999,0,1,7999,1
3939,A,8001,8001,0,0,0,0,8001,0
3939,C,7963,0,7963,0,0,0,7963,0
3940,A,7960,7950,0,0,0,0,7950,10
3940,C,8001,0,8001,0,0,0,8001,0
3941,A,7961,7960,0,0,0,1,7960,1
3941,G,8000,0,0,7999,0,1,7999,1
3942,A,8001,8001,0,0,0,0,8001,0
3942,G,7964,0,0,7958,0,2,7958,6
3943,G,7965,0,0,7965,0,0,7965,0
3943,T,8002,0,0,0,0,8002,8002,0
3944,A,7999,7998,0,0,0,0,7998,1
3944,T,7960,0,0,2,0,7957,7957,3
3945,G,7955,0,0,7743,0,1,7743,212
3945,G,8000,0,0,8000,0,0,8000,0
3946,G,7954,0,0,7953,0,1,7953,1
3946,T,7991,0,0,0,0,7985,7985,6
3947,G,7962,0,0,7961,0,1,7961,1
3947,T,7991,0,0,0,0,7991,7991,0
3948,A,7998,7997,1,0,0,0,7997,1
3948,G,7962,0,0,7961,0,1,7961,1
3949,C,7997,0,7993,0,0,0,7993,4
3949,G,7960,1,0,7959,0,0,7959,1
3950,C,7998,2,7993,1,0,2,7993,5
3950,G,7957,0,0,7957,0,0,7957,0
3951,C,7954,0,7953,0,0,1,7953,1
3951,G,7992,0,1,7982,0,1,7982,10
3952,A,7948,7947,0,0,0,0,7947,1
3952,G,8000,0,0,8000,0,0,8000,0
3953,A,8001,8000,0,0,0,0,8000,1
3953,T,7949,0,0,2,0,7944,7944,5
3954,G,7954,1,0,7952,0,0,7952,2
3954,T,8000,0,0,0,0,8000,8000,0
3955,A,7989,7985,0,0,0,0,7985,4
3955,G,7959,1,0,7958,0,0,7958,1
3956,A,7998,7995,0,2,0,1,7995,3
3956,T,7953,2,0,3,0,7947,7947,6
3957,G,7953,0,0,7938,0,1,7938,15
3957,G,7998,1,0,7988,0,1,7988,10
3958,G,7951,1,0,7950,0,0,7950,1
3958,G,8000,1,0,7998,0,0,7998,2
3959,C,7998,0,7996,0,0,1,7996,2
3959,G,7948,1,0,7947,0,0,7947,1
3960,C,7949,0,7946,1,0,1,7946,3
3960,G,7977,2,0,7973,0,1,7973,4
3961,C,7979,0,7978,1,0,0,7978,1
3961,G,7949,0,1,7940,0,0,7940,9
3962,A,7976,7975,0,0,0,0,7975,1
3962,G,7963,0,1,7962,0,0,7962,1
3963,C,7964,0,7963,0,0,1,7963,1
3963,G,7990,0,0,7990,0,0,7990,0
3964,A,7963,7958,0,0,0,0,7958,5
3964,C,7996,0,7994,0,0,2,7994,2
3965,A,7964,7963,0,0,0,1,7963,1
3965,G,7996,1,0,7989,0,0,7989,7
3966,G,7965,1,0,7963,0,1,7963,2
3966,G,7998,0,0,7998,0,0,7998,0
3967,A,7965,7961,0,0,0,0,7961,4
3967,T,7996,0,0,0,0,7996,7996,0
3968,A,7965,7965,0,0,0,0,7965,0
3968,C,7996,0,7994,0,0,1,7994,2
3969,C,7966,1,7941,0,0,0,7941,25
3969,G,7998,0,1,7953,0,0,7953,45
3970,C,7964,0,7961,0,0,2,7961,3
3970,G,7999,0,0,7999,0,0,7999,0
3971,C,7960,0,7960,0,0,0,7960,0
3971,G,8000,2,0,7998,0,0,7998,2
3972,A,7956,7950,1,0,0,0,7950,6
3972,C,7998,0,7998,0,0,0,7998,0
3973,A,7961,7960,0,0,0,0,7960,1
3973,T,7997,0,0,0,0,7997,7997,0
3974,G,7962,0,0,7955,0,0,7955,7
3974,G,7999,1,0,7997,0,0,7997,2
3975,A,7997,7993,0,0,0,0,7993,4
3975,G,7962,0,0,7961,0,1,7961,1
3976,A,7998,7998,0,0,0,0,7998,0
3976,T,7958,1,1,0,0,7956,7956,2
3977,C,7956,0,7956,0,0,0,7956,0
3977,C,7999,0,7999,0,0,0,7999,0
3978,G,7997,1,0,7669,0,1,7669,328
3978,T,7950,2,2,0,0,7945,7945,5
3979,G,7982,1,0,7980,0,1,7980,2
3979,T,7948,0,0,1,0,7946,7946,2
3980,G,7947,0,0,7947,0,0,7947,0
3980,G,7984,1,0,7983,0,0,7983,1
3981,A,7947,7947,0,0,0,0,7947,0
3981,G,7990,0,0,7990,0,0,7990,0
3982,G,7953,0,0,7952,0,0,7952,1
3982,G,7997,0,0,7997,0,0,7997,0
3983,C,7955,0,7916,0,0,2,7916,39
3983,G,7994,0,0,7992,0,2,7992,2
3984,C,7913,0,7913,0,0,0,7913,0
3984,T,7990,1,1,0,0,7982,7982,8
3985,C,7934,0,7934,0,0,0,7934,0
3985,T,7994,0,0,0,0,7994,7994,0
3986,C,7993,0,7993,0,0,0,7993,0
3986,T,7932,1,0,0,0,7925,7925,7
3987,G,7995,0,0,7994,0,0,7994,1
3987,T,7964,0,1,0,0,7963,7963,1
3988,C,7965,0,7964,1,0,0,7964,1
3988,T,7996,0,2,0,0,7994,7994,2
3989,G,7964,0,1,7963,0,0,7963,1
3989,G,7998,0,0,7998,0,0,7998,0
3990,C,7965,0,7965,0,0,0,7965,0
3990,C,7998,0,7996,0,0,2,7996,2
3991,A,7999,7997,1,0,0,0,7997,2
3991,T,7963,0,0,0,0,7963,7963,0
3992,A,7956,7953,0,0,0,0,7953,3
3992,C,7998,1,7993,0,0,4,7993,5
3993,A,7962,7961,0,1,0,0,7961,1
3993,A,7988,7987,1,0,0,0,7987,1
3994,C,7999,0,7999,0,0,0,7999,0
3994,T,7955,0,0,0,0,7955,7955,0
3995,A,7987,7984,0,1,0,0,7984,3
3995,G,7958,1,0,7957,0,0,7957,1
3996,C,7952,0,7950,0,0,1,7950,2
3996,G,7999,0,0,7999,0,0,7999,0
3997,C,7999,0,7973,0,0,2,7973,26
3997,G,7950,0,1,7920,0,1,7920,30
3998,C,7995,1,7994,0,0,0,7994,1
3998,G,7964,1,0,7963,0,0,7963,1
3999,C,7995,0,7993,0,0,2,7993,2
3999,G,7962,0,0,7960,0,0,7960,2
4000,A,7960,7947,0,0,0,0,7947,13
4000,A,7997,7994,0,2,0,1,7994,3
4001,A,7962,7961,0,0,0,1,7961,1
4001,G,7999,0,0,7999,0,0,7999,0
4002,A,7961,7960,0,1,0,0,7960,1
4002,C,8000,0,7998,0,0,2,7998,2
4003,G,7961,0,0,7961,0,0,7961,0
4003,T,7994,0,0,0,0,7991,7991,3
4004,C,7959,0,7957,1,0,0,7957,2
4004,T,7994,0,1,1,0,7992,7992,2
4005,G,7964,0,0,7961,0,1,7961,3
4005,T,7958,0,1,0,0,7956,7956,2
4006,C,7959,0,7959,0,0,0,7959,0
4006,G,7965,0,0,7965,0,0,7965,0
4007,A,7965,7963,0,1,0,1,7963,2
4007,T,7959,0,0,0,0,7957,7957,2
4008,G,7970,0,0,7969,0,0,7969,1
4008,T,7962,0,0,0,0,7962,7962,0
4009,A,7964,7964,0,0,0,0,7964,0
4009,C,7951,0,7951,0,0,0,7951,0
4010,G,7941,1,0,7940,0,0,7940,1
4010,T,7963,0,1,0,0,7959,7959,4
4011,A,7941,7939,0,0,0,0,7939,2
4011,T,7964,0,1,0,0,7963,7963,1
4012,A,7942,7941,0,1,0,0,7941,1
4012,C,7943,0,7938,0,0,2,7938,5
4013,C,7960,0,7958,1,0,0,7958,2
4013,G,7938,1,0,7926,0,0,7926,12
4014,G,7952,0,0,7952,0,0,7952,0
4014,G,8000,0,0,7997,0,1,7997,3
4015,A,8000,7999,0,0,0,0,7999,1
4015,G,7952,1,0,7949,0,0,7949,3
4016,C,8001,0,7991,0,0,2,7991,10
4016,T,7947,0,0,0,0,7947,7947,0
4017,C,8002,2,7999,0,0,1,7999,3
4017,G,7964,0,0,7962,0,0,7962,2
4018,A,7962,7956,0,2,0,1,7956,6
4018,T,8002,1,1,0,0,8000,8000,2
4019,A,8003,8003,0,0,0,0,8003,0
4019,G,7963,1,0,7959,0,0,7959,4
4020,A,7962,7962,0,0,0,0,7962,0
4020,C,8003,0,8003,0,0,0,8003,0
4021,A,8003,8002,0,1,0,0,8002,1
4021,T,7962,0,1,0,0,7959,7959,3
4022,C,8004,0,7997,0,0,2,7997,7
4022,G,7962,0,0,7931,0,0,7931,31
4023,C,7966,0,7966,0,0,0,7966,0
4023,G,7957,0,0,7957,0,0,7957,0
4024,G,7964,2,0,7962,0,0,7962,2
4024,G,7971,1,0,7970,0,0,7970,1
4025,A,7976,7975,0,0,0,0,7975,1
4025,C,7964,0,7964,0,0,0,7964,0
4026,A,7978,7978,0,0,0,0,7978,0
4026,T,7944,0,0,0,0,7944,7944,0
4027,C,7997,0,7997,0,0,0,7997,0
4027,G,7964,0,0,7954,0,0,7954,10
4028,G,7954,1,0,7953,0,0,7953,1
4028,T,7988,0,2,0,0,7985,7985,3
4029,G,7959,0,0,7959,0,0,7959,0
4029,G,7999,0,0,7999,0,0,7999,0
4030,A,7998,7998,0,0,0,0,7998,0
4030,C,7960,0,7958,0,0,1,7958,2
4031,A,7949,7947,1,1,0,0,7947,2
4031,G,8000,0,0,8000,0,0,8000,0
4032,A,7999,7999,0,0,0,0,7999,0
4032,C,7962,0,7961,0,0,0,7961,1
4033,C,7946,0,7946,0,0,0,7946,0
4033,T,7991,0,0,0,0,7991,7991,0
4034,A,7952,7951,0,0,0,1,7951,1
4034,A,7999,7998,0,1,0,0,7998,1
4035,C,8000,0,7996,0,0,0,7996,4
4035,T,7964,0,1,0,0,7963,7963,1
4036,C,7959,0,7959,0,0,0,7959,0
4036,C,7997,1,7996,0,0,0,7996,1
4037,T,7952,0,3,0,0,7949,7949,3
4037,T,7997,1,0,0,0,7996,7996,1
4038,A,7987,7987,0,0,0,0,7987,0
4038,G,7954,1,0,7899,0,2,7899,55
4039,C,7999,0,7997,0,0,2,7997,2
4039,G,7953,0,0,7951,0,2,7951,2
4040,A,7985,7982,0,3,0,0,7982,3
4040,G,7958,0,0,7957,0,1,7957,1
4041,G,7946,1,0,7945,0,0,7945,1
4041,G,8000,0,0,8000,0,0,8000,0
4042,A,7927,7923,1,2,0,0,7923,4
4042,C,7982,0,7982,0,0,0,7982,0
4043,C,7933,0,7924,0,0,0,7924,9
4043,G,7981,3,0,7978,0,0,7978,3
4044,C,7906,0,7906,0,0,0,7906,0
4044,T,7955,0,0,1,0,7954,7954,1
4045,C,7905,0,7905,0,0,0,7905,0
4045,G,7958,0,0,7957,0,0,7957,1
4046,A,8000,7999,0,0,0,0,7999,1
4046,T,7903,0,0,0,0,7903,7903,0
4047,G,7925,0,0,7925,0,0,7925,0
4047,G,8000,0,0,8000,0,0,8000,0
4048,A,7928,7927,0,1,0,0,7927,1
4048,C,7999,0,7998,0,0,0,7998,1
4049,C,7933,0,7931,0,0,1,7931,2
4049,T,7997,0,0,0,0,7997,7997,0
4050,A,7992,7992,0,0,0,0,7992,0
4050,G,7933,0,0,7933,0,0,7933,0
4051,T,7929,0,0,0,0,7929,7929,0
4051,T,7991,0,4,0,0,7987,7987,4
4052,G,7928,0,0,7926,0,1,7926,2
4052,G,7995,0,0,7994,0,0,7994,1
4053,A,7930,7926,0,1,0,0,7926,4
4053,A,7998,7997,0,0,0,0,7997,1
4054,A,7931,7929,0,1,0,1,7929,2
4054,G,8000,0,0,8000,0,0,8000,0
4055,A,7981,7973,0,0,0,0,7973,8
4055,G,7954,0,0,7954,0,0,7954,0
4056,A,7980,7980,0,0,0,0,7980,0
4056,T,7947,0,0,0,0,7926,7926,21
4057,A,7975,7973,1,1,0,0,7973,2
4057,T,7948,0,0,0,0,7948,7948,0
4058,G,7997,0,0,7997,0,0,7997,0
4058,T,7948,0,3,0,0,7945,7945,3
4059,C,7997,0,7995,0,0,1,7995,2
4059,G,7964,0,0,7964,0,0,7964,0
4060,G,7999,1,1,7997,0,0,7997,2
4060,T,7965,0,0,0,0,7965,7965,0
4061,C,7965,0,7965,0,0,0,7965,0
4061,C,8000,0,7995,0,0,0,7995,5
4062,A,7962,7961,0,0,0,0,7961,1
4062,C,7998,0,7997,0,0,0,7997,1
4063,A,7997,7997,0,0,0,0,7997,0
4063,C,7964,0,7963,0,0,0,7963,1
4064,C,7999,0,7996,0,0,2,7996,3
4064,T,7960,0,0,1,0,7959,7959,1
4065,G,7964,2,0,7962,0,0,7962,2
4065,G,8000,0,0,8000,0,0,8000,0
4066,A,7960,7959,0,0,0,1,7959,1
4066,C,8001,0,8000,0,0,0,8000,1
4067,C,7964,0,7964,0,0,0,7964,0
4067,T,7998,0,0,0,0,7996,7996,2
4068,T,7959,0,2,0,0,7957,7957,2
4068,T,7999,0,0,0,0,7999,7999,0
4069,C,7999,0,7949,0,0,1,7949,50
4069,G,7964,0,0,7959,0,2,7959,5
4070,C,8000,0,8000,0,0,0,8000,0
4070,G,7965,0,0,7964,0,1,7964,1
4071,A,7964,7961,0,2,0,1,7961,3
4071,C,8000,3,7996,1,0,0,7996,4
4072,G,7965,1,0,7963,0,0,7963,2
4072,G,8001,2,0,7997,0,1,7997,4
4073,A,7959,7957,0,0,0,0,7957,2
4073,A,8000,7999,0,0,0,0,7999,1
4074,A,7953,7953,0,0,0,0,7953,0
4074,A,8001,8001,0,0,0,0,8001,0
4075,C,7955,0,7955,0,0,0,7955,0
4075,G,7995,0,0,7947,0,1,7947,48
4076,G,7999,1,0,7998,0,0,7998,1
4076,T,7950,0,0,0,0,7949,7949,1
4077,C,7964,0,7962,0,0,2,7962,2
4077,G,7999,2,0,7997,0,0,7997,2
4078,A,7995,7993,0,1,0,0,7993,2
4078,G,7964,0,0,7952,0,1,7952,12
4079,G,7965,0,0,7964,0,1,7964,1
4079,G,7996,3,0,7989,0,1,7989,7
4080,A,7997,7987,0,1,0,1,7987,10
4080,T,7966,0,0,0,0,7942,7942,24
4081,A,8000,8000,0,0,0,0,8000,0
4081,T,7966,0,1,0,0,7965,7965,1
4082,A,8001,8001,0,0,0,0,8001,0
4082,T,7966,0,5,0,0,7961,7961,5
4083,G,7965,0,0,7964,0,0,7964,1
4083,G,8001,0,0,7996,0,0,7996,5
4084,G,8002,0,0,8001,0,0,8001,1
4084,T,7964,0,0,0,0,7962,7962,2
4085,C,7965,0,7963,1,0,1,7963,2
4085,C,7990,1,7987,0,0,1,7987,3
4086,G,7966,0,1,7965,0,0,7965,1
4086,G,7996,0,0,7979,0,1,7979,17
4087,G,8000,2,0,7998,0,0,7998,2
4087,T,7961,0,0,0,0,7960,7960,1
4088,A,8000,8000,0,0,0,0,8000,0
4088,C,7963,0,7963,0,0,0,7963,0
4089,C,8001,0,8001,0,0,0,8001,0
4089,T,7964,0,0,0,0,7963,7963,1
4090,A,8000,7998,0,1,0,0,7998,2
4090,G,7964,0,0,7963,0,0,7963,1
4091,G,8001,0,0,7997,0,2,7997,4
4091,T,7966,1,0,0,0,7959,7959,7
4092,G,8001,0,0,8001,0,0,8001,0
4092,T,7963,1,1,0,0,7961,7961,2
4093,G,7963,1,0,7961,0,1,7961,2
4093,T,7996,0,1,0,0,7995,7995,1
4094,A,7998,7998,0,0,0,0,7998,0
4094,C,7963,0,7959,1,0,2,7959,4
4095,G,7963,1,1,7833,0,1,7833,130
4095,T,8000,0,0,2,0,7996,7996,4
4096,C,8000,0,7995,0,0,2,7995,5
4096,G,7962,0,0,7962,0,0,7962,0
4097,C,8001,0,7999,0,0,2,7999,2
4097,G,7963,0,0,7963,0,0,7963,0
4098,G,7964,0,0,7964,0,0,7964,0
4098,G,8001,1,2,7990,0,0,7990,11
4099,G,7956,0,1,7955,0,0,7955,1
4099,G,8002,0,0,8002,0,0,8002,0
4100,C,7955,0,7950,2,0,2,7950,5
4100,T,7977,0,0,0,0,7977,7977,0
4101,A,7979,7977,0,0,0,0,7977,2
4101,G,7954,2,1,7946,0,0,7946,8
4102,A,7980,7978,0,2,0,0,7978,2
4102,G,7957,0,1,7955,0,1,7955,2
4103,C,7964,0,7963,0,0,1,7963,1
4103,G,7992,2,0,7990,0,0,7990,2
4104,A,7965,7962,0,2,0,0,7962,3
4104,C,7998,1,7997,0,0,0,7997,1
4105,G,7966,0,0,7966,0,0,7966,0
4105,G,7997,0,0,7988,0,1,7988,9
4106,G,7999,4,0,7995,0,0,7995,4
4106,T,7966,0,1,0,0,7957,7957,9
4107,C,7999,0,7998,0,0,1,7998,1
4107,T,7959,0,0,0,0,7959,7959,0
4108,A,7960,7960,0,0,0,0,7960,0
4108,A,7997,7995,0,1,0,1,7995,2
4109,G,7999,0,0,7988,0,0,7988,11
4109,T,7964,0,1,1,0,7959,7959,5
4110,G,7965,1,0,7957,0,0,7957,8
4110,G,7999,0,0,7999,0,0,7999,0
4111,G,7965,0,0,7964,0,0,7964,1
4111,G,8000,0,0,8000,0,0,8000,0
4112,C,7953,0,7953,0,0,0,7953,0
4112,T,7999,0,0,0,0,7999,7999,0
4113,C,8000,0,7999,0,0,0,7999,1
4113,G,7947,0,0,7945,0,0,7945,2
4114,G,7935,3,0,7932,0,0,7932,3
4114,G,8001,0,0,7999,0,0,7999,2
4115,G,8002,0,0,8002,0,0,8002,0
4115,T,7929,0,0,1,0,7927,7927,2
4116,A,8003,8000,0,0,0,0,8000,3
4116,G,7932,0,0,7932,0,0,7932,0
4117,A,8004,8004,0,0,0,0,8004,0
4117,C,7964,0,7950,0,0,0,7950,14
4118,C,7962,0,7961,0,0,0,7961,1
4118,C,8005,0,8003,0,0,1,8003,2
4119,A,7984,7980,1,1,0,0,7980,4
4119,G,7963,0,1,7961,0,1,7961,2
4120,G,7999,1,0,7988,0,0,7988,11
4120,T,7962,0,2,0,0,7954,7954,8
4121,G,8000,0,0,8000,0,0,8000,0
4121,T,7962,0,0,0,0,7961,7961,1
4122,A,7997,7996,0,1,0,0,7996,1
4122,G,7963,0,0,7946,0,1,7946,17
4123,G,7961,1,0,7960,0,0,7960,1
4123,G,7999,0,0,7998,0,0,7998,1
4124,A,7915,7913,0,1,0,0,7913,2
4124,G,7964,1,0,7963,0,0,7963,1
4125,C,7965,1,7964,0,0,0,7964,1
4125,G,7971,0,0,7971,0,0,7971,0
4126,A,7925,7925,0,0,0,0,7925,0
4126,C,7968,0,7966,0,0,1,7966,2
4127,G,7964,3,0,7961,0,0,7961,3
4127,G,7992,0,0,7991,0,0,7991,1
4128,C,7999,0,7999,0,0,0,7999,0
4128,T,7956,0,0,1,0,7955,7955,1
4129,A,7989,7989,0,0,0,0,7989,0
4129,G,7959,1,0,7957,0,1,7957,2
4130,C,7963,2,7961,0,0,0,7961,2
4130,C,7998,0,7998,0,0,0,7998,0
4131,A,7956,7955,0,1,0,0,7955,1
4131,G,8000,0,0,7999,0,1,7999,1
4132,A,8001,8000,0,1,0,0,8000,1
4132,C,7964,0,7954,0,0,0,7954,10
4133,C,7962,0,7962,0,0,0,7962,0
4133,G,8002,2,0,7948,0,0,7948,54
4134,C,7962,2,7957,1,0,2,7957,5
4134,G,7985,0,0,7985,0,0,7985,0
4135,G,7964,1,0,7960,0,2,7960,4
4135,G,7988,0,0,7988,0,0,7988,0
4136,A,7988,7986,0,1,0,0,7986,2
4136,T,7949,0,0,0,0,7949,7949,0
4137,A,7964,7962,0,1,0,0,7962,2
4137,G,7995,1,1,7993,0,0,7993,2
4138,C,7965,1,7960,0,0,0,7960,5
4138,C,7999,0,7998,0,0,1,7998,1
4139,C,7960,0,7960,0,0,0,7960,0
4139,T,7998,0,1,0,0,7996,7996,2
4140,T,7956,0,0,0,0,7936,7936,20
4140,T,8000,0,1,0,0,7999,7999,1
4141,C,7999,0,7986,0,0,0,7986,13
4141,T,7949,0,0,1,0,7948,7948,1
4142,C,7997,0,7997,0,0,0,7997,0
4142,T,7949,0,0,2,0,7946,7946,3
4143,A,7999,7997,0,0,0,1,7997,2
4143,G,7948,1,0,7906,0,1,7906,42
4144,G,7944,0,0,7944,0,0,7944,0
4144,G,7999,1,0,7616,0,1,7616,383
4145,G,7944,0,0,7943,0,1,7943,1
4145,G,7997,0,0,7997,0,0,7997,0
4146,A,7930,7929,0,1,0,0,7929,1
4146,G,7999,0,0,7999,0,0,7999,0
4147,G,7938,0,0,7933,0,0,7933,5
4147,G,7994,1,0,7993,0,0,7993,1
4148,C,7906,0,7905,0,0,1,7905,1
4148,G,7987,3,0,7981,0,0,7981,6
4149,A,7981,7961,0,3,0,0,7961,20
4149,G,7910,1,0,7908,0,1,7908,2
4150,A,7985,7985,0,0,0,0,7985,0
4150,C,7907,0,7907,0,0,0,7907,0
4151,A,7986,7986,0,0,0,0,7986,0
4151,G,7907,2,0,7905,0,0,7905,2
4152,C,7916,0,7914,0,0,1,7914,2
4152,C,8000,0,7997,0,0,2,7997,3
4153,G,7916,0,0,7916,0,0,7916,0
4153,G,8001,1,0,8000,0,0,8000,1
4154,C,7934,0,7898,0,0,1,7898,36
4154,C,8001,0,7994,0,0,0,7994,7
4155,C,7933,0,7931,0,0,2,7931,2
4155,C,7997,1,7995,0,0,1,7995,2
4156,C,7944,0,7943,1,0,0,7943,1
4156,T,7997,0,2,0,0,7995,7995,2
4157,G,7999,0,0,7991,0,1,7991,8
4157,T,7945,0,2,0,0,7941,7941,4
4158,C,7951,1,7949,0,0,1,7949,2
4158,G,8000,0,0,8000,0,0,8000,0
4159,G,7961,6,0,7952,0,0,7952,9
4159,T,8001,0,0,0,0,8000,8000,1
4160,A,8002,8001,0,1,0,0,8001,1
4160,T,7961,0,2,0,0,7959,7959,2
4161,C,7961,1,7959,0,0,0,7959,2
4161,T,7998,0,0,0,0,7997,7997,1
4162,C,7999,0,7998,0,0,1,7998,1
4162,G,7963,0,0,7963,0,0,7963,0
4163,T,7957,0,1,1,0,7954,7954,3
4163,T,7991,1,0,0,0,7981,7981,10
4164,G,7964,0,0,7963,0,0,7963,1
4164,T,8000,0,0,0,0,8000,8000,0
4165,T,7955,0,1,0,0,7954,7954,1
4165,T,8001,1,1,0,0,7999,7999,2
4166,A,7998,7997,1,0,0,0,7997,1
4166,C,7955,0,7955,0,0,0,7955,0
4167,G,7956,0,0,7956,0,0,7956,0
4167,T,7996,1,0,0,0,7995,7995,1
4168,A,7972,7970,0,1,0,0,7970,2
4168,T,7953,0,1,0,0,7952,7952,1
4169,G,7961,1,0,7960,0,0,7960,1
4169,G,8000,0,0,7999,0,0,7999,1
4170,A,7964,7964,0,0,0,0,7964,0
4170,T,7974,0,0,0,0,7972,7972,2
4171,C,7964,0,7964,0,0,0,7964,0
4171,C,7972,0,7964,0,0,0,7964,8
4172,C,7973,0,7972,0,0,0,7972,1
4172,G,7965,1,0,7963,0,1,7963,2
4173,T,7937,0,1,0,0,7936,7936,1
4173,T,7954,0,1,0,0,7953,7953,1
4174,C,7964,0,7962,0,0,2,7962,2
4174,G,7950,2,0,7947,0,0,7947,3
4175,A,7964,7964,0,0,0,0,7964,0
4175,T,7950,0,0,0,0,7950,7950,0
4176,C,7951,0,7947,0,0,2,7947,4
4176,C,7965,1,7950,0,0,0,7950,15
4177,C,7965,0,7965,0,0,0,7965,0
4177,G,7951,0,1,7915,0,1,7915,36
4178,C,7964,0,7964,0,0,0,7964,0
4178,G,7962,0,0,7962,0,0,7962,0
4179,G,7962,2,0,15920,0,0,15920,-7958
4180,T,7955,0,0,0,0,7940,7940,15
4180,T,7960,0,0,2,0,7956,7956,4
4181,T,7958,0,0,0,0,15916,15916,-7958
4182,C,7964,1,7963,0,0,0,7963,1
4182,T,7958,0,0,0,0,7958,7958,0
4183,C,7979,0,7979,0,0,0,7979,0
4183,T,7958,0,0,0,0,7958,7958,0
4184,G,7964,0,0,7964,0,0,7964,0
4184,G,7979,2,0,7976,0,1,7976,3
4185,C,7982,0,7976,0,0,0,7976,6
4185,T,7962,0,0,1,0,7956,7956,6
4186,C,7982,1,7981,0,0,0,7981,1
4186,T,7961,0,0,0,0,7961,7961,0
4187,A,7981,7980,0,1,0,0,7980,1
4187,G,7964,0,0,7953,0,0,7953,11
4188,C,8000,0,7996,0,0,1,7996,4
4188,G,7958,0,0,7958,0,0,7958,0
4189,C,7964,0,7964,0,0,0,7964,0
4189,C,8001,2,7998,0,0,0,7998,3
4190,T,7962,2,0,0,0,7958,7958,4
4190,T,8001,1,2,0,0,7998,7998,3
4191,C,8003,0,8003,0,0,0,8003,0
4191,T,7956,0,0,0,0,7956,7956,0
4192,A,7963,7960,0,2,0,0,7960,3
4192,T,7998,0,1,1,0,7996,7996,2
4193,G,8000,2,0,7998,0,0,7998,2
4193,T,7964,0,0,0,0,7964,7964,0
4194,A,7961,7958,0,0,0,0,7958,3
4194,A,8001,8001,0,0,0,0,8001,0
4195,A,7964,7964,0,0,0,0,7964,0
4195,C,8002,0,8002,0,0,0,8002,0
4196,T,7938,0,0,1,0,7936,7936,2
4196,T,8002,0,3,0,0,7993,7993,9
4197,G,7937,1,0,7936,0,0,7936,1
4197,T,7983,0,1,0,0,7982,7982,1
4198,C,7935,0,7935,0,0,0,7935,0
4198,G,7987,0,0,7987,0,0,7987,0
4199,A,7903,7903,0,0,0,0,7903,0
4199,A,7982,7982,0,0,0,0,7982,0
4200,G,7963,0,0,7940,0,3,7940,23
4200,G,7983,0,0,7982,0,1,7982,1
4201,C,7982,0,7980,1,0,1,7980,2
4201,G,7951,1,0,7949,0,1,7949,2
4202,G,7964,0,0,7962,0,2,7962,2
4202,G,7980,2,0,7977,0,1,7977,3
4203,T,7961,0,0,3,0,7958,7958,3
4203,T,7980,0,0,0,0,7977,7977,3
4204,C,7982,0,7982,0,0,0,7982,0
4204,G,7947,1,0,7900,0,2,7900,47
4205,G,7948,0,0,7945,0,3,7945,3
4205,G,7983,1,0,7982,0,0,7982,1
4206,A,7997,7995,1,0,0,0,7995,2
4206,G,7950,0,0,7950,0,0,7950,0
4207,G,7950,1,0,7948,0,0,7948,2
4207,T,7999,0,0,0,0,7874,7874,125
4208,C,7951,0,7936,4,0,2,7936,15
4208,T,7998,0,0,0,0,7998,7998,0
4209,C,7923,0,7923,0,0,0,7923,0
4209,T,8000,1,0,0,0,7999,7999,1
4210,A,7927,7927,0,0,0,0,7927,0
4210,T,8001,0,1,0,0,7999,7999,2
4211,C,7946,0,7940,0,0,0,7940,6
4211,T,8000,0,0,0,0,8000,8000,0
4212,C,7944,0,7944,0,0,0,7944,0
4212,G,8001,0,0,8000,0,1,8000,1
4213,T,7944,0,2,0,0,7942,7942,2
4213,T,8000,0,2,0,0,7998,7998,2
4214,G,7964,0,0,7963,0,0,7963,1
4214,G,8001,0,0,8000,0,0,8000,1
4215,A,8000,7999,1,0,0,0,7999,1
4215,C,7962,0,7956,0,0,0,7956,6
4216,C,7962,0,7961,0,0,0,7961,1
4216,T,7998,0,0,0,0,7998,7998,0
4217,G,7960,2,0,7953,0,0,7953,7
4217,G,7999,0,0,7999,0,0,7999,0
4218,C,7999,0,7995,0,0,3,7995,4
4218,G,7964,0,0,7964,0,0,7964,0
4219,T,7965,0,0,0,0,7964,7964,1
4219,T,7999,0,0,0,0,7999,7999,0
4220,A,7964,7964,0,0,0,0,7964,0
4220,C,8000,0,8000,0,0,0,8000,0
4221,G,7963,0,0,7959,0,2,7959,4
4221,G,8000,2,0,7998,0,0,7998,2
4222,G,7964,0,0,7964,0,0,7964,0
4222,T,8001,0,0,1,0,7999,7999,2
4223,C,8001,0,8001,0,0,0,8001,0
4223,T,7947,0,0,0,0,7946,7946,1
4224,A,8001,7999,1,0,0,0,7999,2
4224,G,7951,2,0,7948,0,1,7948,3
4225,G,8001,0,0,7618,0,0,7618,383
4225,T,7947,0,1,0,0,7945,7945,2
4226,G,7964,0,0,7962,0,2,7962,2
4226,G,7994,0,0,7993,0,0,7993,1
4227,C,7965,0,7964,0,0,1,7964,1
4227,G,7987,1,0,7985,0,1,7985,2
4228,G,7965,0,0,7959,0,0,7959,6
4228,G,7994,0,0,7993,0,1,7993,1
4229,G,7964,1,0,7963,0,0,7963,1
4229,G,7982,0,0,7981,0,1,7981,1
4230,G,7984,0,2,7980,0,0,7980,4
4230,T,7955,0,0,0,0,7955,7955,0
4231,A,7938,7937,0,0,0,0,7937,1
4231,C,7980,0,7977,1,0,1,7977,3
4232,G,7943,1,0,7933,0,2,7933,10
4232,G,7980,0,0,7973,0,0,7973,7
4233,G,7963,2,0,7961,0,0,7961,2
4233,G,7987,0,0,7987,0,0,7987,0
4234,A,7987,7986,0,0,0,0,7986,1
4234,C,7964,0,7961,0,0,2,7961,3
4235,G,7995,1,0,7992,0,0,7992,3
4235,T,7954,0,1,0,0,7924,7924,30
4236,C,7996,0,7983,0,0,1,7983,13
4236,T,7954,0,0,1,0,7953,7953,1
4237,C,7995,2,7993,0,0,0,7993,2
4237,T,7954,0,1,0,0,7953,7953,1
4238,T,7953,0,1,0,0,7951,7951,2
4238,T,7989,0,2,0,0,7986,7986,3
4239,A,7996,7996,0,0,0,0,7996,0
4239,C,7953,0,7952,0,0,0,7952,1
4240,T,7949,0,0,0,0,7948,7948,1
4240,T,7997,1,0,0,0,7995,7995,2
4241,C,7955,0,7950,0,0,1,7950,5
4241,G,7999,1,0,7984,0,0,7984,15
4242,C,7946,0,7946,0,0,0,7946,0
4242,G,8000,1,1,7998,0,0,7998,2
4243,A,8000,7944,0,0,0,0,7944,56
4243,G,7951,0,0,7950,0,1,7950,1
4244,A,7988,7988,0,0,0,0,7988,0
4244,T,7964,0,0,0,0,7964,7964,0
4245,A,7989,7988,0,0,0,1,7988,1
4245,C,7963,0,7963,0,0,0,7963,0
4246,A,7991,7990,0,1,0,0,7990,1
4246,G,7964,1,0,7963,0,0,7963,1
4247,A,7992,7991,1,0,0,0,7991,1
4247,C,7964,0,7964,0,0,0,7964,0
4248,A,7962,7959,0,2,0,1,7959,3
4248,C,7996,0,7995,0,0,0,7995,1
4249,G,7964,3,0,7942,0,0,7942,22
4249,G,7996,1,0,7994,0,0,7994,2
4250,C,7996,1,7994,0,0,0,7994,2
4250,G,7964,2,0,7962,0,0,7962,2
4251,A,7965,7964,0,1,0,0,7964,1
4251,C,7996,0,7996,0,0,0,7996,0
4252,A,7996,7995,0,1,0,0,7995,1
4252,C,7965,0,7964,0,0,0,7964,1
4253,G,7960,4,0,7955,0,0,7955,5
4253,G,7997,0,0,7996,0,1,7996,1
4254,C,7962,0,7962,0,0,0,7962,0
4254,C,7998,0,7997,0,0,1,7997,1
4255,A,7961,7958,0,2,0,1,7958,3
4255,A,7999,7993,0,1,0,0,7993,6
4256,A,8000,7996,1,1,0,2,7996,4
4256,G,7963,0,1,7943,0,0,7943,20
4257,C,7994,0,7993,0,0,1,7993,1
4257,G,7965,0,0,7965,0,0,7965,0
4258,G,7966,0,0,7966,0,0,7966,0
4258,G,7994,0,0,7994,0,0,7994,0
4259,C,7992,0,7991,0,0,0,7991,1
4259,T,7962,0,0,1,0,7957,7957,5
4260,G,7993,1,0,7989,0,0,7989,4
4260,T,7960,1,1,0,0,7958,7958,2
4261,C,7957,2,7951,1,0,2,7951,6
4261,G,7997,0,1,7996,0,0,7996,1
4262,C,7998,0,7981,0,0,1,7981,17
4262,G,7958,0,0,7920,0,0,7920,38
4263,C,7999,0,7998,0,0,0,7998,1
4263,G,7964,0,0,7964,0,0,7964,0
4264,G,7965,2,0,7963,0,0,7963,2
4264,T,7999,0,1,0,0,7916,7916,83
4265,C,7956,0,7947,0,0,0,7947,9
4265,T,8000,0,1,0,0,7999,7999,1
4266,C,7950,1,7949,0,0,0,7949,1
4266,T,8001,0,0,0,0,8001,8001,0
4267,T,7920,0,1,0,0,7919,7919,1
4267,T,8002,0,0,0,0,8002,8002,0
4268,A,7962,7960,0,0,0,0,7960,2
4268,T,8003,1,0,0,0,8002,8002,1
4269,A,8003,8002,0,0,0,0,8002,1
4269,G,7964,0,0,7945,0,0,7945,19
4270,C,8002,0,8000,0,0,2,8000,2
4270,G,7965,0,0,7964,0,1,7964,1
4271,G,7965,0,0,7965,0,0,7965,0
4271,G,7996,1,0,7993,0,0,7993,3
4272,G,7999,0,0,7999,0,0,7999,0
4272,T,7935,0,1,0,0,7933,7933,2
4273,A,7933,7932,0,0,0,0,7932,1
4273,T,7980,0,0,0,0,7972,7972,8
4274,G,7932,0,0,7930,0,0,7930,2
4274,T,7995,0,0,0,0,7995,7995,0
4275,C,7996,0,7995,0,0,0,7995,1
4275,G,7948,0,0,7948,0,0,7948,0
4276,C,7951,0,7951,0,0,0,7951,0
4276,C,7992,1,7991,0,0,0,7991,1
4277,T,7910,0,0,0,0,7910,7910,0
4277,T,7992,1,4,0,0,7987,7987,5
4278,C,7940,0,7939,0,0,1,7939,1
4278,G,7997,0,0,7982,0,0,7982,15
4279,G,7998,1,0,7996,0,0,7996,2
4279,T,7932,0,0,0,0,7930,7930,2
4280,C,7946,0,7943,0,0,0,7943,3
4280,C,7998,0,7990,0,0,2,7990,8
4281,C,7946,0,7946,0,0,0,7946,0
4281,C,7981,0,7981,0,0,0,7981,0
4282,T,7941,1,2,0,0,7938,7938,3
4282,T,7980,0,0,0,0,7950,7950,30
4283,G,7945,1,0,7944,0,0,7944,1
4283,T,7984,0,0,0,0,7984,7984,0
4284,A,7944,7938,0,0,0,0,7938,6
4284,T,7999,0,0,0,0,7999,7999,0
4285,A,7946,7946,0,0,0,0,7946,0
4285,T,8000,0,1,0,0,7999,7999,1
4286,G,8001,1,0,8000,0,0,8000,1
4286,T,7946,0,0,1,0,7945,7945,1
4287,C,7928,0,7928,0,0,0,7928,0
4287,C,8001,0,8000,0,0,1,8000,1
4288,G,7931,0,0,7931,0,0,7931,0
4288,T,7996,0,0,0,0,7994,7994,2
4289,A,7926,7926,0,0,0,0,7926,0
4289,G,7999,2,0,7990,0,0,7990,9
4290,C,7926,0,7924,0,0,1,7924,2
4290,G,7999,0,0,7999,0,0,7999,0
4291,A,7924,7923,0,0,0,0,7923,1
4291,C,8000,0,7994,0,0,1,7994,6
4292,C,7998,1,7997,0,0,0,7997,1
4292,G,7923,0,1,7916,0,1,7916,7
4293,G,7939,1,0,7936,0,0,7936,3
4293,T,7990,0,1,0,0,7966,7966,24
4294,C,7943,0,7940,1,0,1,7940,3
4294,T,7994,1,0,0,0,7993,7993,1
4295,G,7945,0,1,7942,0,0,7942,3
4295,T,7999,0,0,0,0,7999,7999,0
4296,C,7946,0,7943,0,0,0,7943,3
4296,T,7999,0,0,1,0,7998,7998,1
4297,C,7945,1,7941,1,0,2,7941,4
4297,G,8000,0,0,8000,0,0,8000,0
4298,C,7994,0,7992,0,0,1,7992,2
4298,G,7945,0,0,7924,0,1,7924,21
4299,G,7960,2,0,7958,0,0,7958,2
4299,T,7994,0,1,0,0,7993,7993,1
4300,A,7962,7960,1,1,0,0,7960,2
4300,C,7998,0,7996,0,0,1,7996,2
4301,A,7994,7992,0,2,0,0,7992,2
4301,C,7962,0,7952,0,0,0,7952,10
4302,C,7954,1,7953,0,0,0,7953,1
4302,C,7999,0,7999,0,0,0,7999,0
4303,A,7999,7998,0,0,0,0,7998,1
4303,T,7957,0,1,0,0,7956,7956,1
4304,C,7964,0,7963,0,0,1,7963,1
4304,T,7996,0,1,0,0,7995,7995,1
4305,G,7998,2,0,7995,0,1,7995,3
4305,T,7963,0,0,0,0,7963,7963,0
4306,G,7964,0,0,7957,0,0,7957,7
4306,T,7995,0,0,0,0,7988,7988,7
4307,G,7964,1,0,7963,0,0,7963,1
4307,T,7996,0,0,0,0,7995,7995,1
4308,C,7998,1,7995,0,0,2,7995,3
4308,T,7960,0,0,2,0,7958,7958,2
4309,G,7962,0,0,7960,0,1,7960,2
4309,T,7992,0,2,0,0,7983,7983,9
4310,A,7947,7947,0,0,0,0,7947,0
4310,T,7999,0,1,0,0,7998,7998,1
4311,G,7963,0,0,7875,0,1,7875,88
4311,T,7998,0,0,0,0,7998,7998,0
4312,C,7999,0,7993,0,0,0,7993,6
4312,G,7962,0,0,7962,0,0,7962,0
4313,C,8000,0,7998,0,0,2,7998,2
4313,G,7950,0,0,7950,0,0,7950,0
4314,G,7962,0,0,7962,0,0,7962,0
4314,T,7988,0,0,0,0,7988,7988,0
4315,A,7955,7950,0,5,0,0,7950,5
4315,G,8000,0,0,8000,0,0,8000,0
4316,C,8000,0,7999,0,0,1,7999,1
4316,G,7963,2,0,7934,0,1,7934,29
4317,G,7964,0,0,7964,0,0,7964,0
4317,G,7999,0,0,7997,0,1,7997,2
4318,G,7964,0,0,7964,0,0,7964,0
4318,T,7997,0,0,0,0,7993,7993,4
4319,A,7964,7963,0,0,0,0,7963,1
4319,T,7988,0,0,1,0,7987,7987,1
4320,A,8000,7998,0,0,0,1,7998,2
4320,T,7950,0,0,0,0,7949,7949,1
4321,A,7950,7949,0,0,0,0,7949,1
4321,T,8000,0,5,0,0,7995,7995,5
4322,A,7959,7959,0,0,0,0,7959,0
4322,C,8001,0,7842,0,0,0,7842,159
4323,C,8000,1,7999,0,0,0,7999,1
4323,G,7964,0,0,7964,0,0,7964,0
4324,C,7992,0,7990,0,0,2,7990,2
4324,T,7961,0,1,0,0,7959,7959,2
4325,C,7991,1,7988,0,0,1,7988,3
4325,G,7957,1,0,7956,0,0,7956,1
4326,A,7923,7923,0,0,0,0,7923,0
4326,T,7984,1,1,0,0,7982,7982,2
4327,G,7925,0,0,7922,0,0,7922,3
4327,G,7998,0,0,7997,0,0,7997,1
4328,A,8000,7999,0,1,0,0,7999,1
4328,G,7924,1,0,7923,0,0,7923,1
4329,C,7921,2,7919,0,0,0,7919,2
4329,T,7997,0,0,0,0,7995,7995,2
4330,G,7921,4,0,7917,0,0,7917,4
4330,T,7996,0,1,0,0,7995,7995,1
4331,C,7998,0,7998,0,0,0,7998,0
4331,T,7919,0,0,0,0,7919,7919,0
4332,C,7926,0,7925,0,0,1,7925,1
4332,T,7985,0,2,0,0,7982,7982,3
4333,A,7928,7928,0,0,0,0,7928,0
4333,G,8000,0,0,8000,0,0,8000,0
4334,G,7931,0,0,7931,0,0,7931,0
4334,T,8000,0,1,0,0,7998,7998,2
4335,G,8001,0,0,7997,0,0,7997,4
4335,T,7931,0,0,0,0,7917,7917,14
4336,G,8001,0,0,8001,0,0,8001,0
4336,T,7934,0,0,0,0,7934,7934,0
4337,A,7991,7990,0,1,0,0,7990,1
4337,T,7939,0,0,0,0,7939,7939,0
4338,C,7939,0,7938,0,0,0,7938,1
4338,T,8000,0,0,0,0,7999,7999,1
4339,A,8001,7991,1,0,0,0,7991,10
4339,T,7936,0,0,0,0,7926,7926,10
4340,A,7999,7999,0,0,0,0,7999,0
4340,T,7936,0,0,0,0,7936,7936,0
4341,C,8000,1,7988,0,0,0,7988,12
4341,T,7935,0,0,0,0,7934,7934,1
4342,C,7990,1,7988,1,0,0,7988,2
4342,G,7937,1,0,7929,0,0,7929,8
4343,G,7937,0,0,7937,0,0,7937,0
4343,G,7999,2,0,7997,0,0,7997,2
4344,T,7936,0,0,0,0,7936,7936,0
4344,T,7992,0,0,0,0,7992,7992,0
4345,A,7996,7994,0,1,0,1,7994,2
4345,C,7935,0,7935,0,0,0,7935,0
4346,G,7932,0,0,7926,0,0,7926,6
4346,T,7996,0,0,0,0,7994,7994,2
4347,G,7964,0,0,7963,0,0,7963,1
4347,T,7996,0,0,0,0,7996,7996,0
4348,A,7995,7993,0,1,0,0,7993,2
4348,T,7964,0,0,0,0,7929,7929,35
4349,C,7997,0,7993,0,0,0,7993,4
4349,T,7965,1,1,0,0,7963,7963,2
4350,C,7952,0,7951,0,0,1,7951,1
4350,T,7966,0,0,1,0,7965,7965,1
4351,G,7999,0,0,7998,0,1,7998,1
4351,T,7964,0,0,0,0,7963,7963,1
4352,A,7964,7964,0,0,0,0,7964,0
4352,C,7989,0,7981,0,0,0,7981,8
4353,C,7994,0,7994,0,0,0,7994,0
4353,T,7964,0,1,1,0,7962,7962,2
4354,G,7966,0,0,7965,0,0,7965,1
4354,T,7993,0,0,0,0,7982,7982,11
4355,T,7966,0,0,1,0,7965,7965,1
4355,T,7995,0,2,0,0,7993,7993,2
4356,A,7919,7918,0,1,0,0,7918,1
4356,T,8000,0,1,0,0,7999,7999,1
4357,C,7934,1,7931,0,0,0,7931,3
4357,G,8001,2,0,7999,0,0,7999,2
4358,A,8002,8000,0,1,0,1,8000,2
4358,C,7926,2,7924,0,0,0,7924,2
4359,G,8003,2,0,8000,0,0,8000,3
4359,T,7922,0,1,0,0,7921,7921,1
4360,A,7951,7951,0,0,0,0,7951,0
4360,T,7975,0,0,0,0,7975,7975,0
4361,G,7994,0,0,7993,0,0,7993,1
4361,T,7952,0,2,0,0,7948,7948,4
4362,A,7998,7997,0,1,0,0,7997,1
4362,C,7963,0,7963,0,0,0,7963,0
4363,G,8000,1,0,7998,0,1,7998,2
4363,T,7958,0,1,0,0,7949,7949,9
4364,C,8001,0,7998,0,0,3,7998,3
4364,T,7963,0,0,0,0,7963,7963,0
4365,C,7964,1,7963,0,0,0,7963,1
4365,T,7999,0,1,0,0,7997,7997,2
4366,G,7996,0,0,7996,0,0,7996,0
4366,T,7957,0,1,0,0,7952,7952,5
4367,A,7999,7998,1,0,0,0,7998,1
4367,T,7958,0,0,0,0,7958,7958,0
4368,A,7961,7958,0,1,0,0,7958,3
4368,T,7998,0,0,0,0,7998,7998,0
4369,A,7949,7948,1,0,0,0,7948,1
4369,A,7998,7997,0,0,0,0,7997,1
4370,C,7999,0,7992,0,0,2,7992,7
4370,G,7954,0,0,7953,0,1,7953,1
4371,C,7924,0,7924,0,0,0,7924,0
4371,T,7949,0,0,0,0,7949,7949,0
4372,A,7943,7942,0,1,0,0,7942,1
4372,G,7923,1,0,7921,0,0,7921,2
4373,C,7926,0,7925,0,0,0,7925,1
4373,G,7952,0,0,7952,0,0,7952,0
4374,C,7954,0,7953,0,0,1,7953,1
4374,T,7926,0,1,0,0,7924,7924,2
4375,C,7938,0,7936,0,0,0,7936,2
4375,T,7951,1,1,0,0,7949,7949,2
4376,G,7936,2,0,7934,0,0,7934,2
4376,G,7950,0,0,7950,0,0,7950,0
4377,A,7949,7945,0,0,0,0,7945,4
4377,C,7945,0,7942,0,0,1,7942,3
4378,A,7949,7949,0,0,0,0,7949,0
4378,C,7945,0,7944,0,0,1,7944,1
4379,G,7943,3,0,7940,0,0,7940,3
4379,G,7949,0,0,7949,0,0,7949,0
4380,C,7947,0,7947,0,0,0,7947,0
4380,C,7953,1,7952,0,0,0,7952,1
4381,A,7950,7946,2,2,0,0,7946,4
4381,T,7942,0,1,0,0,7940,7940,2
4382,C,7941,2,7930,0,0,1,7930,11
4382,G,7988,1,0,7987,0,0,7987,1
4383,C,7940,0,7938,0,0,1,7938,2
4383,C,7996,0,7987,0,0,2,7987,9
4384,C,7992,0,7990,1,0,1,7990,2
4384,G,7942,2,1,7932,0,0,7932,10
4385,G,7964,0,0,7964,0,0,7964,0
4385,G,7999,0,0,7999,0,0,7999,0
4386,A,7996,7991,0,0,0,0,7991,5
4386,T,7965,1,0,2,0,7914,7914,51
4387,A,7996,7994,1,1,0,0,7994,2
4387,T,7966,0,0,0,0,7966,7966,0
4388,C,8000,0,7998,1,0,0,7998,2
4388,T,7966,0,0,0,0,7966,7966,0
4389,G,7998,0,0,7998,0,0,7998,0
4389,T,7965,0,1,1,0,7963,7963,2
4390,A,8000,7999,0,1,0,0,7999,1
4390,G,7966,0,0,7966,0,0,7966,0
4391,A,7966,7959,0,0,0,0,7959,7
4391,C,8001,0,7994,0,0,1,7994,7
4392,A,7967,7966,0,1,0,0,7966,1
4392,C,7998,1,7997,0,0,0,7997,1
4393,C,7967,0,7966,0,0,0,7966,1
4393,G,7999,1,0,7997,0,0,7997,2
4394,A,7996,7995,0,0,0,0,7995,1
4394,T,7930,0,0,0,0,7930,7930,0
4395,A,7944,7943,0,1,0,0,7943,1
4395,G,8000,0,0,7998,0,2,7998,2
4396,C,8001,0,7999,0,0,2,7999,2
4396,T,7941,0,2,0,0,7939,7939,2
4397,G,7945,0,0,7944,0,1,7944,1
4397,G,7999,2,0,7997,0,0,7997,2
4398,C,7950,1,7949,0,0,0,7949,1
4398,C,8000,1,7999,0,0,0,7999,1
4399,A,7986,7985,0,1,0,0,7985,1
4399,G,7946,0,0,7946,0,0,7946,0
4400,C,7953,0,7953,0,0,0,7953,0
4400,G,8000,1,0,7998,0,1,7998,2
4401,C,8000,0,7996,0,0,4,7996,4
4401,T,7951,0,0,0,0,7951,7951,0
4402,C,7954,0,7953,0,0,0,7953,1
4402,G,8001,1,0,8000,0,0,8000,1
4403,A,7999,7998,0,0,0,1,7998,1
4403,G,7956,0,0,7838,0,0,7838,118
4404,G,7957,0,0,7957,0,0,7957,0
4404,G,8000,0,0,8000,0,0,8000,0
4405,G,7961,0,0,7960,0,1,7960,1
4405,T,8001,0,0,0,0,8001,8001,0
4406,C,8002,0,8002,0,0,0,8002,0
4406,G,7962,0,0,7960,0,1,7960,2
4407,A,7994,7992,0,1,0,0,7992,2
4407,T,7960,0,1,2,0,7951,7951,9
4408,G,8000,1,0,7996,0,0,7996,4
4408,T,7960,0,0,0,0,7960,7960,0
4409,G,7960,2,0,7954,0,1,7954,6
4409,T,7997,0,1,0,0,7995,7995,2
4410,G,7961,0,0,7961,0,0,7961,0
4410,G,7999,0,0,7998,0,0,7998,1
4411,A,7993,7993,0,0,0,0,7993,0
4411,C,7963,1,7962,0,0,0,7962,1
4412,G,7963,0,0,7962,0,0,7962,1
4412,G,7998,0,0,7997,0,0,7997,1
4413,A,7926,7926,0,0,0,0,7926,0
4413,C,7992,0,7990,1,0,1,7990,2
4414,G,7932,1,0,7928,0,0,7928,4
4414,G,7994,0,1,7993,0,0,7993,1
4415,A,8000,7998,0,0,0,0,7998,2
4415,T,7922,0,0,0,0,7922,7922,0
4416,G,7934,1,0,7931,0,0,7931,3
4416,G,8001,0,0,7996,0,0,7996,5
4417,G,7999,0,0,7998,0,0,7998,1
4417,T,7934,0,0,0,0,7930,7930,4
4418,A,7997,7992,0,0,0,0,7992,5
4418,G,7946,1,0,7944,0,0,7944,2
4419,A,7993,7991,0,1,0,0,7991,2
4419,T,7946,0,0,0,0,7883,7883,63
4420,G,7997,0,0,7992,0,1,7992,5
4420,T,7950,0,0,0,0,7950,7950,0
4421,C,7995,0,7995,0,0,0,7995,0
4421,T,7949,0,0,0,0,7949,7949,0
4422,G,7997,1,0,7983,0,0,7983,14
4422,T,7946,0,0,0,0,7946,7946,0
4423,G,7947,1,1,7945,0,0,7945,2
4423,G,8000,1,0,7999,0,0,7999,1
4424,A,7999,7994,1,1,0,0,7994,5
4424,T,7944,0,1,0,0,7942,7942,2
4425,A,8000,8000,0,0,0,0,8000,0
4425,G,7944,0,0,7944,0,0,7944,0
4426,A,7945,7940,0,1,0,0,7940,5
4426,G,8001,0,0,7999,0,1,7999,2
4427,A,7936,7934,0,1,0,0,7934,2
4427,A,7992,7992,0,0,0,0,7992,0
4428,G,7949,0,0,7947,0,0,7947,2
4428,G,8000,3,0,7995,0,0,7995,5
4429,C,7994,0,7988,1,0,2,7988,6
4429,T,7949,0,0,0,0,7771,7771,178
4430,G,7999,1,1,7997,0,0,7997,2
4430,T,7962,0,0,0,0,7962,7962,0
4431,C,8000,0,7983,2,0,0,7983,17
4431,T,7964,0,0,0,0,7964,7964,0
4432,C,8001,0,7999,0,0,2,7999,2
4432,T,7965,0,0,0,0,7965,7965,0
4433,C,8000,0,8000,0,0,0,8000,0
4433,T,7966,0,2,0,0,7964,7964,2
4434,A,7999,7993,0,0,0,1,7993,6
4434,T,7967,0,0,0,0,7966,7966,1
4435,A,7967,7967,0,0,0,0,7967,0
4435,A,8000,7998,1,0,0,1,7998,2
4436,G,7969,0,0,7963,0,1,7963,6
4436,T,8001,0,0,1,0,8000,8000,1
4437,A,7998,7996,1,0,0,1,7996,2
4437,G,7965,1,0,7964,0,0,7964,1
4438,C,7963,0,7960,0,0,3,7960,3
4438,C,7997,0,7993,0,0,3,7993,4
4439,A,7962,7961,0,0,0,0,7961,1
4439,G,7991,1,0,7990,0,0,7990,1
4440,C,7964,0,7962,0,0,0,7962,2
4440,C,7994,0,7991,0,0,2,7991,3
4441,A,7991,7971,0,1,0,0,7971,20
4441,C,7962,1,7960,0,0,1,7960,2
4442,A,8000,7999,0,1,0,0,7999,1
4442,T,7963,0,1,0,0,7922,7922,41
4443,A,8001,7998,1,2,0,0,7998,3
4443,T,7962,1,0,0,0,7961,7961,1
4444,C,8001,1,7999,0,0,0,7999,2
4444,T,7964,1,0,0,0,7963,7963,1
4445,C,7990,0,7989,0,0,1,7989,1
4445,T,7965,0,0,0,0,7965,7965,0
4446,G,7966,0,0,7964,0,2,7964,2
4446,G,7994,1,0,7993,0,0,7993,1
4447,A,7966,7953,0,2,0,0,7953,13
4447,C,7994,0,7983,0,0,0,7983,11
4448,A,7966,7965,0,0,0,1,7965,1
4448,C,7994,0,7993,0,0,0,7993,1
4449,A,7963,7962,1,0,0,0,7962,1
4449,T,7992,0,1,0,0,7991,7991,1
4450,C,8000,0,8000,0,0,0,8000,0
4450,T,7948,0,0,0,0,7947,7947,1
4451,G,7964,0,0,7964,0,0,7964,0
4451,T,7999,0,9,1,0,7988,7988,11
4452,C,8000,0,7883,0,0,2,7883,117
4452,T,7958,0,0,0,0,7958,7958,0
4453,A,7959,7949,0,1,0,0,7949,10
4453,C,7994,0,7994,0,0,0,7994,0
4454,A,7960,7959,1,0,0,0,7959,1
4454,C,7996,1,7993,1,0,1,7993,3
4455,C,7993,0,7989,2,0,0,7989,4
4455,T,7962,0,0,0,0,7962,7962,0
4456,C,7964,0,7964,0,0,0,7964,0
4456,G,7993,0,1,7992,0,0,7992,1
4457,A,7965,7963,0,0,0,1,7963,2
4457,C,8000,0,7998,0,0,1,7998,2
4458,G,8001,1,0,7998,0,0,7998,3
4458,T,7960,1,0,0,0,7950,7950,10
4459,C,7995,1,7993,1,0,0,7993,2
4459,T,7959,1,0,0,0,7958,7958,1
4460,G,7995,2,0,7993,0,0,7993,2
4460,T,7953,0,0,0,0,7953,7953,0
4461,G,7959,0,0,7936,0,1,7936,23
4461,T,7993,0,1,1,0,7988,7988,5
4462,G,7963,0,0,7963,0,0,7963,0
4462,T,7993,0,1,2,0,7990,7990,3
4463,G,7964,0,0,7964,0,0,7964,0
4463,G,8000,0,0,7991,0,0,7991,9
4464,G,8000,0,0,8000,0,0,8000,0
4464,T,7960,0,0,0,0,7960,7960,0
4465,C,7955,0,7955,0,0,0,7955,0
4465,C,8000,1,7997,0,0,2,7997,3
4466,A,7953,7944,1,1,0,1,7944,9
4466,C,8000,0,8000,0,0,0,8000,0
4467,A,7963,7963,0,0,0,0,7963,0
4467,G,7994,1,0,7993,0,0,7993,1
4468,A,8000,7998,0,1,0,0,7998,2
4468,T,7964,1,0,0,0,7963,7963,1
4469,A,7965,7964,0,0,0,1,7964,1
4469,T,8000,0,0,0,0,7998,7998,2
4470,T,7961,1,1,0,0,7959,7959,2
4470,T,8001,0,1,0,0,8000,8000,1
4471,C,8002,0,8001,0,0,1,8001,1
4471,G,7959,0,0,7957,0,0,7957,2
4472,A,8003,8001,0,1,0,0,8001,2
4472,T,7960,0,0,0,0,7960,7960,0
4473,A,7964,7958,0,1,0,0,7958,6
4473,T,8004,0,0,0,0,8002,8002,2
4474,A,7964,7964,0,0,0,0,7964,0
4474,T,8004,0,0,1,0,8003,8003,1
4475,A,8004,7997,0,0,0,0,7997,7
4475,T,7965,0,0,0,0,7939,7939,26
4476,A,8005,8003,0,0,0,2,8003,2
4476,T,7945,0,0,0,0,7945,7945,0
4477,T,7944,0,0,0,0,7944,7944,0
4477,T,7990,0,1,1,0,7988,7988,2
4478,G,7991,0,0,7991,0,0,7991,0
4478,T,7941,1,1,0,0,7939,7939,2
4479,C,7941,0,7940,0,0,0,7940,1
4479,C,7999,1,7997,0,0,1,7997,2
4480,A,7937,7936,1,0,0,0,7936,1
4480,A,7959,7956,1,1,0,1,7956,3
4481,G,7964,0,0,7963,0,1,7963,1
4481,G,7970,2,0,7968,0,0,7968,2
4482,C,7969,0,7954,0,0,1,7954,15
4482,T,7963,0,0,0,0,7963,7963,0
4483,G,7963,0,0,7963,0,0,7963,0
4483,T,7969,1,1,0,0,7967,7967,2
4484,G,7974,1,0,7961,0,0,7961,13
4484,T,7963,0,1,0,0,7961,7961,2
4485,G,7978,1,0,7977,0,0,7977,1
4485,T,7963,0,0,0,0,7963,7963,0
4486,A,7963,7962,0,0,0,0,7962,1
4486,C,7983,0,7981,0,0,2,7981,2
4487,A,7983,7980,2,0,0,0,7980,3
4487,G,7963,0,0,7963,0,0,7963,0
4488,A,7965,7964,0,0,0,0,7964,1
4488,C,7984,1,7980,0,0,1,7980,4
4489,C,7965,0,7964,0,0,0,7964,1
4489,G,7985,0,0,7984,0,0,7984,1
4490,A,7986,7986,0,0,0,0,7986,0
4490,T,7937,0,0,0,0,7935,7935,2
4491,C,7987,1,7986,0,0,0,7986,1
4491,T,7964,0,1,0,0,7963,7963,1
4492,A,7985,7983,0,1,0,0,7983,2
4492,G,7965,1,0,7963,0,0,7963,2
4493,G,7986,0,0,7977,0,0,7977,9
4493,T,7964,0,1,0,0,7961,7961,3
4494,A,7965,7953,0,0,0,1,7953,12
4494,G,7987,0,0,7987,0,0,7987,0
4495,A,7965,7965,0,0,0,0,7965,0
4495,T,7985,0,0,0,0,7956,7956,29
4496,A,7962,7961,0,1,0,0,7961,1
4496,T,7985,0,0,2,0,7983,7983,2
4497,T,7962,0,1,0,0,7959,7959,3
4497,T,7985,0,0,0,0,7983,7983,2
4498,C,7984,0,7955,0,0,2,7955,29
4498,T,7946,0,0,1,0,7945,7945,1
4499,C,7986,0,7986,0,0,0,7986,0
4499,G,7948,0,1,7946,0,1,7946,2
4500,C,7984,0,7983,0,0,1,7983,1
4500,T,7939,0,0,0,0,7939,7939,0
4501,C,7940,1,7923,0,0,0,7923,17
4501,G,7984,1,0,7981,0,1,7981,3
4502,A,7985,7983,0,1,0,0,7983,2
4502,C,7936,0,7935,0,0,0,7935,1
4503,C,7986,0,7985,0,0,0,7985,1
4503,G,7962,1,1,7958,0,0,7958,4
4504,C,7963,0,7963,0,0,0,7963,0
4504,T,7983,0,0,0,0,7983,7983,0
4505,G,7987,1,0,7975,0,0,7975,12
4505,T,7963,0,0,0,0,7962,7962,1
4506,A,7964,7957,0,0,0,1,7957,7
4506,G,7988,0,0,7988,0,0,7988,0
4507,A,7964,7963,0,0,0,0,7963,1
4507,A,7988,7978,0,2,0,0,7978,10
4508,A,7964,7964,0,0,0,0,7964,0
4508,A,7988,7988,0,0,0,0,7988,0
4509,A,7988,7987,0,1,0,0,7987,1
4509,T,7965,0,0,0,0,7957,7957,8
4510,G,7989,0,0,7988,0,0,7988,1
4510,T,7962,0,0,0,0,7962,7962,0
4511,C,7961,0,7961,0,0,0,7961,0
4511,C,7982,0,7976,4,0,1,7976,6
4512,G,7982,0,2,7956,0,0,7956,26
4512,T,7949,1,0,0,0,7948,7948,1
4513,G,7950,2,0,7938,0,1,7938,12
4513,G,7987,0,0,7987,0,0,7987,0
4514,G,7950,0,0,7948,0,2,7948,2
4514,G,7985,0,0,7985,0,0,7985,0
4515,C,7949,0,7946,1,0,0,7946,3
4515,C,7987,0,7985,0,0,2,7985,2
4516,A,7984,7984,0,0,0,0,7984,0
4516,C,7948,0,7947,0,0,1,7947,1
4517,G,7951,0,1,7950,0,0,7950,1
4517,G,7987,2,0,7984,0,0,7984,3
4518,T,7954,0,0,1,0,7858,7858,96
4518,T,7985,0,0,0,0,7985,7985,0
4519,G,7987,0,0,7987,0,0,7987,0
4519,T,7954,0,0,0,0,7954,7954,0
4520,A,7983,7981,0,2,0,0,7981,2
4520,T,7954,0,2,0,0,7952,7952,2
4521,G,7987,0,0,7987,0,0,7987,0
4521,T,7954,0,1,1,0,7952,7952,2
4522,C,7986,0,7984,0,0,1,7984,2
4522,T,7952,0,0,2,0,7949,7949,3
4523,G,7951,0,0,7942,0,0,7942,9
4523,G,7987,1,0,7985,0,0,7985,2
4524,C,7987,1,7986,0,0,0,7986,1
4524,G,7954,0,0,7953,0,1,7953,1
4525,A,7983,7976,1,0,0,0,7976,7
4525,C,7954,0,7953,0,0,0,7953,1
4526,A,7987,7986,1,0,0,0,7986,1
4526,T,7952,0,2,0,0,7844,7844,108
4527,C,7987,0,7984,0,0,1,7984,3
4527,T,7952,0,1,0,0,7951,7951,1
4528,G,7986,1,0,7985,0,0,7985,1
4528,T,7953,0,1,1,0,7951,7951,2
4529,C,7987,0,7987,0,0,0,7987,0
4529,T,7953,0,0,0,0,7953,7953,0
4530,A,7988,7980,0,0,0,0,7980,8
4530,T,7963,0,1,0,0,7962,7962,1
4531,A,7989,7989,0,0,0,0,7989,0
4531,T,7963,0,0,0,0,7962,7962,1
4532,G,7963,0,0,7963,0,0,7963,0
4532,T,7989,2,0,0,0,7977,7977,12
4533,T,7963,0,2,0,0,7955,7955,8
4533,T,7989,0,1,0,0,7988,7988,1
4534,A,7990,7980,0,0,0,0,7980,10
4534,T,7962,1,1,0,0,7960,7960,2
4535,A,7964,7963,0,0,0,1,7963,1
4535,A,7989,7987,0,1,0,1,7987,2
4536,G,7965,0,0,7965,0,0,7965,0
4536,T,7989,0,0,0,0,7987,7987,2
4537,A,7965,7965,0,0,0,0,7965,0
4537,G,7990,2,0,7987,0,1,7987,3
4538,C,7965,1,7964,0,0,0,7964,1
4538,T,7956,0,0,1,0,7955,7955,1
4539,A,7959,7951,1,2,0,0,7951,8
4539,G,7987,0,0,7985,0,0,7985,2
4540,A,7963,7963,0,0,0,0,7963,0
4540,A,7983,7983,0,0,0,0,7983,0
4541,C,7963,0,7961,0,0,2,7961,2
4541,G,7987,1,0,7985,0,1,7985,2
4542,A,7964,7963,0,0,0,0,7963,1
4542,T,7984,0,0,0,0,7983,7983,1
4543,T,7965,0,0,0,0,7964,7964,1
4543,T,7980,0,1,0,0,7979,7979,1
4544,A,7982,7982,0,0,0,0,7982,0
4544,G,7961,0,0,7960,0,0,7960,1
4545,A,7963,7963,0,0,0,0,7963,0
4545,G,7987,2,1,7984,0,0,7984,3
4546,C,7963,0,7958,0,0,0,7958,5
4546,C,7988,0,7987,0,0,0,7987,1
4547,C,7938,0,7938,0,0,0,7938,0
4547,T,7987,0,1,0,0,7985,7985,2
4548,C,7976,0,7976,0,0,0,7976,0
4548,G,7963,0,0,7963,0,0,7963,0
4549,A,7947,7947,0,0,0,0,7947,0
4549,A,7972,7970,0,1,0,0,7970,2
4550,C,7986,0,7986,0,0,0,7986,0
4550,G,7963,0,0,7963,0,0,7963,0
4551,T,7964,0,1,0,0,7963,7963,1
4551,T,7986,0,1,0,0,7985,7985,1
4552,A,7965,7965,0,0,0,0,7965,0
4552,C,7987,0,7987,0,0,0,7987,0
4553,A,7986,7985,0,0,0,0,7985,1
4553,C,7966,1,7965,0,0,0,7965,1
4554,A,7947,7938,1,0,0,0,7938,9
4554,T,7984,1,0,0,0,7980,7980,4
4555,A,7963,7961,0,1,0,1,7961,2
4555,T,7984,0,0,0,0,7984,7984,0
4556,A,7987,7984,0,1,0,0,7984,3
4556,G,7964,0,0,7964,0,0,7964,0
4557,C,7958,0,7930,0,0,0,7930,28
4557,G,7978,0,0,7974,0,1,7974,4
4558,C,7957,2,7955,0,0,0,7955,2
4558,G,7977,2,0,7975,0,0,7975,2
4559,C,7923,0,7922,0,0,0,7922,1
4559,C,7935,0,7934,0,0,0,7934,1
4560,A,7925,7925,0,0,0,0,7925,0
4560,A,7970,7968,2,0,0,0,7968,2
4561,C,7939,0,7938,0,0,1,7938,1
4561,C,7980,1,7893,0,0,0,7893,87
4562,C,7982,1,7981,0,0,0,7981,1
4562,G,7939,1,0,7931,0,1,7931,8
4563,C,7981,0,7981,0,0,0,7981,0
4563,G,7958,1,0,7957,0,0,7957,1
4564,C,7981,1,7979,0,0,0,7979,2
4564,T,7949,0,0,0,0,7948,7948,1
4565,A,7985,7983,0,1,0,1,7983,2
4565,G,7952,0,0,7952,0,0,7952,0
4566,C,7948,0,7945,0,0,0,7945,3
4566,G,7987,2,0,7977,0,0,7977,10
4567,G,7948,0,0,7947,0,0,7947,1
4567,G,7988,0,0,7988,0,0,7988,0
4568,C,7956,0,7953,0,0,0,7953,3
4568,C,7988,1,7987,0,0,0,7987,1
4569,C,7954,0,7953,0,0,0,7953,1
4569,T,7974,0,0,0,0,7969,7969,5
4570,T,7945,0,0,0,0,7945,7945,0
4570,T,7950,0,0,0,0,7950,7950,0
4571,C,7957,0,7956,0,0,1,7956,1
4571,T,7944,0,0,0,0,7944,7944,0
4572,A,7948,7947,1,0,0,0,7947,1
4572,G,7958,1,0,7957,0,0,7957,1
4573,C,7958,0,7946,0,0,2,7946,12
4573,C,7985,0,7981,0,0,2,7981,4
4574,A,7985,7985,0,0,0,0,7985,0
4574,C,7956,0,7955,0,0,1,7955,1
4575,A,7962,7961,0,1,0,0,7961,1
4575,C,7986,0,7986,0,0,0,7986,0
4576,C,7964,0,7951,0,0,1,7951,13
4576,T,7953,1,0,0,0,7939,7939,14
4577,C,7960,0,7960,0,0,0,7960,0
4577,T,7979,1,1,0,0,7977,7977,2
4578,C,7963,1,7959,2,0,1,7959,4
4578,T,7980,0,0,0,0,7980,7980,0
4579,A,7979,7979,0,0,0,0,7979,0
4579,G,7963,0,3,7958,0,0,7958,5
4580,C,7962,0,7961,0,0,0,7961,1
4580,T,7983,0,0,0,0,7983,7983,0
4581,G,7961,1,0,7959,0,0,7959,2
4581,G,7983,1,0,7982,0,0,7982,1
4582,A,7964,7962,1,0,0,0,7962,2
4582,C,7979,1,7978,0,0,0,7978,1
4583,C,7965,0,7963,0,0,1,7963,2
4583,T,7966,0,1,0,0,7964,7964,2
4584,G,7962,0,0,7962,0,0,7962,0
4584,T,7952,0,1,0,0,7951,7951,1
4585,A,7963,7963,0,0,0,0,7963,0
4585,C,7952,0,7941,0,0,0,7941,11
4586,C,7948,0,7946,0,0,1,7946,2
4586,C,7964,1,7961,0,0,2,7961,3
4587,G,7963,1,0,7961,0,0,7961,2
4587,G,7965,1,0,7962,0,0,7962,3
4588,G,7986,0,1,7985,0,0,7985,1
4588,T,7961,0,1,0,0,7960,7960,1
4589,C,7964,0,7890,0,0,0,7890,74
4589,C,7986,1,7983,1,0,1,7983,3
4590,C,7964,0,7964,0,0,0,7964,0
4590,T,7986,0,0,0,0,7985,7985,1
4591,C,7964,0,7963,0,0,0,7963,1
4591,C,7982,0,7982,0,0,0,7982,0
4592,C,7963,1,7961,0,0,0,7961,2
4592,G,7983,1,0,7982,0,0,7982,1
4593,A,7956,7954,1,1,0,0,7954,2
4593,T,7987,0,0,0,0,7987,7987,0
4594,A,7988,7988,0,0,0,0,7988,0
4594,G,7963,1,0,7928,0,0,7928,35
4595,G,7963,0,0,7963,0,0,7963,0
4595,T,7985,0,0,0,0,7977,7977,8
4596,G,7959,0,0,7959,0,0,7959,0
4596,G,7982,0,0,7982,0,0,7982,0
4597,C,7962,0,7953,1,0,0,7953,9
4597,T,7964,0,0,0,0,7950,7950,14
4598,C,7917,0,7917,0,0,0,7917,0
4598,T,7940,0,1,0,0,7934,7934,6
4599,G,7949,2,0,7946,0,0,7946,3
4599,G,7982,0,0,7975,0,1,7975,7
4600,T,7952,0,0,1,0,7950,7950,2
4600,T,7967,1,0,0,0,7965,7965,2
4601,A,7956,7955,0,0,0,0,7955,1
4601,G,7986,0,0,7983,0,0,7983,3
4602,C,7957,0,7951,1,0,1,7951,6
4602,T,7984,0,0,0,0,7982,7982,2
4603,G,7951,1,1,7948,0,0,7948,3
4603,G,7986,0,0,7962,0,1,7962,24
4604,C,7957,0,7957,0,0,0,7957,0
4604,G,7988,2,0,7986,0,0,7986,2
4605,A,7945,7943,2,0,0,0,7943,2
4605,A,7983,7978,0,1,0,0,7978,5
4606,A,7986,7986,0,0,0,0,7986,0
4606,C,7954,1,7930,0,0,0,7930,24
4607,C,7953,0,7953,0,0,0,7953,0
4607,T,7986,0,0,0,0,7982,7982,4
4608,C,7944,1,7943,0,0,0,7943,1
4608,T,7977,0,3,0,0,7974,7974,3
4609,G,7980,1,0,7979,0,0,7979,1
4609,T,7942,0,0,1,0,7938,7938,4
4610,C,7944,1,7943,0,0,0,7943,1
4610,T,7968,2,2,0,0,7964,7964,4
4611,G,7945,1,1,7942,0,1,7942,3
4611,G,7972,0,0,7971,0,0,7971,1
4612,A,7968,7968,0,0,0,0,7968,0
4612,C,7946,0,7938,1,0,2,7938,8
4613,C,7944,0,7944,0,0,0,7944,0
4613,G,7986,0,1,7984,0,1,7984,2
4614,C,7982,0,7979,2,0,1,7979,3
4614,G,7944,0,0,7944,0,0,7944,0
4615,C,7942,0,7934,0,0,0,7934,8
4615,G,7977,0,0,7973,0,1,7973,4
4616,C,7939,0,7937,0,0,2,7937,2
4616,G,7987,0,0,7987,0,0,7987,0
4617,A,7986,7984,0,1,0,0,7984,2
4617,G,7943,1,0,7941,0,0,7941,2
4618,C,7943,0,7941,0,0,0,7941,2
4618,T,7987,0,2,0,0,7984,7984,3
4619,A,7988,7983,0,2,0,0,7983,5
4619,G,7944,2,1,7939,0,0,7939,5
4620,A,7989,7989,0,0,0,0,7989,0
4620,T,7948,0,0,0,0,7944,7944,4
4621,C,7990,0,7988,0,0,2,7988,2
4621,T,7951,0,0,0,0,7951,7951,0
4622,A,7989,7983,0,1,0,0,7983,6
4622,C,7955,0,7955,0,0,0,7955,0
4623,A,7990,7990,0,0,0,0,7990,0
4623,G,7961,2,0,7957,0,1,7957,4
4624,C,7963,1,7958,0,0,2,7958,5
4624,T,7989,2,0,0,0,7970,7970,19
4625,C,7964,1,7963,0,0,0,7963,1
4625,T,7976,0,0,0,0,7976,7976,0
4626,G,7965,0,0,7964,0,1,7964,1
4626,T,7982,2,2,0,0,7978,7978,4
4627,A,7965,7963,0,1,0,0,7963,2
4627,C,7978,0,7977,0,0,0,7977,1
4628,A,7985,7982,1,0,0,2,7982,3
4628,C,7965,1,7963,0,0,0,7963,2
4629,C,7987,0,7987,0,0,0,7987,0
4629,T,7965,1,0,0,0,7964,7964,1
4630,A,7966,7965,0,1,0,0,7965,1
4630,A,7980,7980,0,0,0,0,7980,0
4631,C,7966,0,7883,0,0,1,7883,83
4631,C,7987,0,7986,0,0,1,7986,1
4632,A,7985,7983,2,0,0,0,7983,2
4632,C,7963,0,7963,0,0,0,7963,0
4633,C,7965,0,7965,0,0,0,7965,0
4633,G,7987,0,0,7978,0,1,7978,9
4634,C,7964,0,7963,0,0,1,7963,1
4634,G,7988,0,0,7988,0,0,7988,0
4635,A,7989,7971,0,0,0,0,7971,18
4635,G,7962,2,1,7957,0,0,7957,5
4636,A,7989,7988,0,1,0,0,7988,1
4636,C,7964,1,7955,1,0,1,7955,9
4637,A,7989,7988,0,0,0,1,7988,1
4637,C,7961,0,7961,0,0,0,7961,0
4638,A,7964,7962,0,2,0,0,7962,2
4638,C,7990,0,7989,1,0,0,7989,1
4639,A,7991,7989,1,1,0,0,7989,2
4639,C,7963,0,7962,0,0,1,7962,1
4640,G,7962,1,1,7959,0,0,7959,3
4640,G,7991,1,0,7989,0,0,7989,2
4641,C,7964,0,7963,0,0,0,7963,1
4641,C,7989,0,7989,0,0,0,7989,0
4642,G,7965,0,0,7964,0,0,7964,1
4642,T,7973,0,0,0,0,7972,7972,1
4643,A,7980,7979,0,0,0,0,7979,1
4643,C,7966,0,7960,0,0,1,7960,6
4644,C,7964,0,7962,0,0,1,7962,2
4644,T,7977,1,0,0,0,7976,7976,1
4645,A,7964,7964,0,0,0,0,7964,0
4645,G,7987,0,0,7987,0,0,7987,0
4646,A,7988,7988,0,0,0,0,7988,0
4646,C,7966,0,7966,0,0,0,7966,0
4647,A,7965,7965,0,0,0,0,7965,0
4647,C,7981,0,7980,0,0,0,7980,1
4648,C,7966,0,7961,0,0,0,7961,5
4648,C,7976,0,7976,0,0,0,7976,0
4649,A,7944,7943,0,0,0,0,7943,1
4649,C,7946,0,7946,0,0,0,7946,0
4650,G,7949,1,0,7948,0,0,7948,1
4650,T,7986,0,0,0,0,7986,7986,0
4651,G,7987,1,0,7986,0,0,7986,1
4651,T,7950,0,0,0,0,7950,7950,0
4652,A,7987,7986,0,1,0,0,7986,1
4652,C,7944,0,7943,0,0,1,7943,1
4653,G,7964,2,0,7961,0,0,7961,3
4653,T,7987,2,0,0,0,7982,7982,5
4654,A,7962,7962,0,0,0,0,7962,0
4654,T,7963,0,1,0,0,7962,7962,1
4655,A,7970,7970,0,0,0,0,7970,0
4655,T,7963,0,0,0,0,7963,7963,0
4656,C,7963,0,7960,0,0,0,7960,3
4656,C,7983,0,7982,0,0,0,7982,1
4657,C,7954,1,7952,1,0,0,7952,2
4657,G,7987,3,0,7982,0,1,7982,5
4658,C,7980,0,7972,0,0,0,7972,8
4658,G,7955,1,1,7943,0,3,7943,12
4659,C,7963,0,7963,0,0,0,7963,0
4659,G,7961,0,0,7961,0,0,7961,0
4660,A,7959,7959,0,0,0,0,7959,0
4660,A,7962,7960,0,0,0,0,7960,2
4661,A,7963,7963,0,0,0,0,7963,0
4661,C,7965,2,7961,0,0,0,7961,4
4662,C,7962,0,7962,0,0,0,7962,0
4662,G,7987,0,0,7987,0,0,7987,0
4663,C,7988,0,7987,0,0,0,7987,1
4663,G,7962,3,0,7959,0,0,7959,3
4664,C,7965,0,7961,0,0,0,7961,4
4664,T,7987,1,0,0,0,7983,7983,4
4665,C,7966,1,7963,0,0,0,7963,3
4665,C,7976,0,7976,0,0,0,7976,0
4666,A,7965,7964,0,0,0,0,7964,1
4666,T,7974,1,1,0,0,7972,7972,2
4667,A,7987,7986,0,0,0,0,7986,1
4667,C,7968,0,7967,0,0,1,7967,1
4668,A,7968,7968,0,0,0,0,7968,0
4668,G,7988,0,0,7988,0,0,7988,0
4669,C,7987,0,7986,0,0,0,7986,1
4669,T,7969,0,0,0,0,7967,7967,2
4670,C,7962,0,7961,0,0,1,7961,1
4670,T,7987,1,0,0,0,7986,7986,1
4671,A,7948,7947,0,0,0,0,7947,1
4671,G,7965,1,0,7964,0,0,7964,1
4672,A,7960,7959,0,0,0,0,7959,1
4672,G,7956,0,0,7954,0,1,7954,2
4673,A,7956,7953,0,2,0,0,7953,3
4673,G,7962,0,0,7960,0,0,7960,2
4674,C,7960,0,7958,0,0,2,7958,2
4674,G,7978,0,0,7972,0,1,7972,6
4675,G,7962,0,0,7955,0,0,7955,7
4675,G,7987,0,0,7987,0,0,7987,0
4676,G,7963,1,0,7962,0,0,7962,1
4676,T,7968,0,0,0,0,7968,7968,0
4677,C,7970,0,7967,0,0,1,7967,3
4677,G,7964,0,0,7963,0,1,7963,1
4678,G,7973,1,0,7970,0,0,7970,3
4678,T,7964,0,0,0,0,7964,7964,0
4679,A,7986,7985,0,1,0,0,7985,1
4679,C,7966,1,7965,0,0,0,7965,1
4680,A,7966,7966,0,0,0,0,7966,0
4680,C,8000,0,7999,0,0,1,7999,1
4681,C,7967,0,7962,0,0,2,7962,5
4681,G,7994,0,0,7989,0,0,7989,5
4682,C,7967,0,7966,0,0,1,7966,1
4682,G,8000,0,0,8000,0,0,8000,0
4683,G,7968,0,0,7968,0,0,7968,0
4683,T,7996,1,1,1,0,7980,7980,16
4684,A,7967,7966,0,0,0,0,7966,1
4684,A,7998,7997,0,0,0,1,7997,1
4685,G,7956,2,0,7954,0,0,7954,2
4685,T,7999,0,1,1,0,7997,7997,2
4686,A,7999,7983,13,2,0,0,7983,16
4686,C,7956,0,7956,0,0,0,7956,0
4687,C,8000,0,7998,1,0,1,7998,2
4687,T,7956,0,0,0,0,7955,7955,1
4688,A,7969,7966,1,0,0,0,7966,3
4688,G,7964,1,0,7963,0,0,7963,1
4689,C,7966,0,7966,0,0,0,7966,0
4689,G,7999,0,0,7999,0,0,7999,0
4690,A,7967,7965,0,1,0,0,7965,2
4690,A,7996,7996,0,0,0,0,7996,0
4691,A,7967,7966,0,1,0,0,7966,1
4691,C,7936,0,7935,0,0,1,7935,1
4692,A,7919,7918,0,0,0,1,7918,1
4692,G,7968,0,0,7967,0,0,7967,1
4693,A,7965,7962,0,0,0,0,7962,3
4693,T,7967,0,1,0,0,7966,7966,1
4694,A,7965,7964,1,0,0,0,7964,1
4694,G,7989,0,0,7988,0,0,7988,1
4695,A,7998,7997,0,0,0,0,7997,1
4695,C,7962,0,7958,0,0,2,7958,4
4696,T,7960,0,0,0,0,7957,7957,3
4696,T,7999,1,0,0,0,7998,7998,1
4697,A,8000,7997,0,0,0,1,7997,3
4697,C,7964,0,7962,0,0,1,7962,2
4698,A,7977,7974,0,2,0,1,7974,3
4698,T,7960,0,0,0,0,7948,7948,12
4699,G,8000,1,0,7999,0,0,7999,1
4699,T,7963,0,1,0,0,7961,7961,2
4700,A,8000,7998,0,1,0,0,7998,2
4700,C,7964,0,7959,0,0,0,7959,5
4701,C,7959,0,7958,1,0,0,7958,1
4701,T,7999,1,1,0,0,7997,7997,2
4702,A,7972,7971,0,0,0,1,7971,1
4702,T,7958,0,1,0,0,7957,7957,1
4703,C,7957,0,7955,0,0,0,7955,2
4703,C,7979,0,7979,0,0,0,7979,0
4704,A,7954,7954,0,0,0,0,7954,0
4704,A,7988,7985,0,0,0,0,7985,3
4705,C,7958,0,7954,0,0,3,7954,4
4705,T,7990,3,0,0,0,7982,7982,8
4706,G,7957,0,0,7956,0,0,7956,1
4706,T,7980,0,0,0,0,7980,7980,0
4707,C,7950,0,7949,0,0,1,7949,1
4707,G,7993,0,0,7993,0,0,7993,0
4708,A,7984,7982,0,2,0,0,7982,2
4708,G,7949,1,0,7947,0,0,7947,2
4709,C,7957,0,7957,0,0,0,7957,0
4709,T,7979,0,1,0,0,7976,7976,3
4710,G,7957,0,1,7955,0,0,7955,2
4710,G,7993,0,0,7993,0,0,7993,0
4711,A,7986,7986,0,0,0,0,7986,0
4711,T,7957,1,1,0,0,7955,7955,2
4712,C,7956,0,7956,0,0,0,7956,0
4712,G,7990,1,0,7987,0,0,7987,3
4713,G,7964,0,0,7929,0,0,7929,35
4713,T,7986,0,0,0,0,7976,7976,10
4714,G,7963,0,0,7963,0,0,7963,0
4714,T,7987,0,0,0,0,7987,7987,0
4715,G,7965,0,0,7965,0,0,7965,0
4715,T,7987,0,0,0,0,7987,7987,0
4716,C,7964,0,7964,0,0,0,7964,0
4716,G,8000,0,0,7994,0,0,7994,6
4717,G,8001,0,0,8000,0,1,8000,1
4717,T,7964,0,1,0,0,7963,7963,1
4718,A,8001,8001,0,0,0,0,8001,0
4718,C,7961,0,7957,0,0,3,7957,4
4719,C,8001,0,8000,0,0,1,8000,1
4719,G,7963,0,0,7962,0,1,7962,1
4720,A,7964,7964,0,0,0,0,7964,0
4720,A,7979,7963,1,0,0,0,7963,16
4721,A,7998,7998,0,0,0,0,7998,0
4721,C,7965,0,7964,0,0,1,7964,1
4722,A,7963,7962,1,0,0,0,7962,1
4722,A,8000,7998,0,1,0,0,7998,2
4723,C,8000,0,7990,0,0,0,7990,10
4723,T,7960,0,1,1,0,7957,7957,3
4724,C,7960,0,7959,0,0,1,7959,1
4724,C,8001,0,8000,0,0,1,8000,1
4725,A,7998,7997,0,0,0,0,7997,1
4725,G,7964,0,0,7957,0,0,7957,7
4726,C,8000,0,8000,0,0,0,8000,0
4726,G,7965,1,0,7964,0,0,7964,1
4727,A,8001,7996,0,1,0,0,7996,5
4727,C,7965,0,7964,1,0,0,7964,1
4728,A,7962,7953,0,2,0,0,7953,9
4728,A,8002,8001,0,1,0,0,8001,1
4729,A,7961,7958,0,3,0,0,7958,3
4729,C,8003,1,8002,0,0,0,8002,1
4730,G,7964,0,0,7962,0,1,7962,2
4730,T,7997,1,1,0,0,7995,7995,2
4731,A,7998,7997,0,1,0,0,7997,1
4731,G,7965,0,0,7964,0,1,7964,1
4732,G,7997,1,0,7995,0,1,7995,2
4732,T,7963,0,0,2,0,7958,7958,5
4733,A,7993,7990,0,0,0,0,7990,3
4733,G,7963,0,0,7962,0,0,7962,1
4734,A,7993,7993,0,0,0,0,7993,0
4734,T,7955,0,0,5,0,7946,7946,9
4735,G,7956,0,0,7940,0,3,7940,16
4735,T,7976,0,0,0,0,7976,7976,0
4736,G,7960,1,0,7959,0,0,7959,1
4736,G,7977,4,0,7973,0,0,7973,4
4737,C,7979,0,7978,0,0,0,7978,1
4737,G,7964,0,0,7963,0,0,7963,1
4738,A,7947,7947,0,0,0,0,7947,0
4738,T,7962,0,0,0,0,7961,7961,1
4739,C,7918,0,7917,0,0,1,7917,1
4739,G,7964,0,0,7962,0,0,7962,2
4740,G,7928,0,0,7928,0,0,7928,0
4740,T,7960,0,0,0,0,7960,7960,0
4741,C,7925,0,7925,0,0,0,7925,0
4741,G,7969,0,0,7968,0,1,7968,1
4742,A,7969,7830,0,1,0,0,7830,139
4742,G,7925,3,0,7916,0,0,7916,9
4743,A,7982,7982,0,0,0,0,7982,0
4743,G,7931,0,1,7930,0,0,7930,1
4744,A,7931,7931,0,0,0,0,7931,0
4744,A,7985,7985,0,0,0,0,7985,0
4745,A,7987,7987,0,0,0,0,7987,0
4745,C,7932,0,7930,0,0,2,7930,2
4746,A,7986,7986,0,0,0,0,7986,0
4746,G,7929,1,0,7926,0,0,7926,3
4747,A,7930,7925,1,1,0,0,7925,5
4747,A,7986,7986,0,0,0,0,7986,0
4748,A,7993,7993,0,0,0,0,7993,0
4748,C,7930,0,7928,1,0,0,7928,2
4749,G,7929,2,0,7919,0,0,7919,10
4749,T,7995,0,1,0,0,7993,7993,2
4750,G,7935,0,0,7931,0,0,7931,4
4750,G,7996,1,0,7995,0,0,7995,1
4751,C,7931,0,7928,0,0,2,7928,3
4751,C,8000,0,8000,0,0,0,8000,0
4752,G,7932,1,1,7929,0,0,7929,3
4752,T,7998,1,0,0,0,7987,7987,11
4753,C,7938,0,7929,0,0,0,7929,9
4753,T,7999,0,1,0,0,7998,7998,1
4754,C,7934,1,7932,0,0,1,7932,2
4754,T,8000,1,0,0,0,7999,7999,1
4755,A,8001,8000,0,0,0,0,8000,1
4755,G,7934,1,0,7933,0,0,7933,1
4756,C,7937,0,7936,0,0,1,7936,1
4756,T,8002,0,0,0,0,7990,7990,12
4757,G,7936,1,0,7931,0,0,7931,5
4757,T,8002,0,0,0,0,8002,8002,0
4758,G,7945,0,0,7945,0,0,7945,0
4758,T,7999,0,0,0,0,7999,7999,0
4759,G,7999,1,0,7998,0,0,7998,1
4759,T,7944,0,0,0,0,7944,7944,0
4760,G,7944,0,1,7941,0,0,7941,3
4760,T,7999,0,1,0,0,7998,7998,1
4761,G,7945,0,0,7945,0,0,7945,0
4761,G,8000,0,1,7999,0,0,7999,1
4762,A,8001,7993,0,0,0,0,7993,8
4762,C,7944,0,7944,0,0,0,7944,0
4763,A,8002,8001,1,0,0,0,8001,1
4763,G,7962,0,0,7956,0,1,7956,6
4764,A,8003,8002,0,0,0,0,8002,1
4764,G,7962,3,1,7958,0,0,7958,4
4765,T,7960,0,0,0,0,7959,7959,1
4765,T,8003,0,0,0,0,7988,7988,15
4766,C,7962,0,7962,0,0,0,7962,0
4766,T,8005,0,1,0,0,8004,8004,1
4767,T,7960,0,1,0,0,7959,7959,1
4767,T,8005,0,0,0,0,8005,8005,0
4768,G,7964,0,0,7956,0,1,7956,8
4768,G,8006,0,0,8005,0,0,8005,1
4769,G,7965,1,0,7963,0,1,7963,2
4769,T,8006,0,0,0,0,8005,8005,1
4770,A,7962,7960,0,0,0,0,7960,2
4770,G,8006,0,0,8004,0,1,8004,2
4771,A,8007,8006,0,0,0,0,8006,1
4771,C,7963,0,7956,0,0,3,7956,7
4772,C,7910,0,7910,0,0,0,7910,0
4772,T,8004,0,0,0,0,8003,8003,1
4773,A,7944,7943,0,0,0,1,7943,1
4773,G,8005,0,0,8005,0,0,8005,0
4774,C,7964,0,7964,0,0,0,7964,0
4774,C,8005,0,8005,0,0,0,8005,0
4775,G,7964,1,0,7963,0,0,7963,1
4775,T,8003,0,0,0,0,8003,8003,0
4776,A,8004,8004,0,0,0,0,8004,0
4776,C,7965,0,7948,1,0,2,7948,17
4777,C,7962,1,7958,1,0,1,7958,4
4777,T,8004,1,1,1,0,7998,7998,6
4778,G,7961,1,0,7953,0,0,7953,8
4778,T,8006,0,0,0,0,8006,8006,0
4779,G,7962,0,1,7961,0,0,7961,1
4779,G,8007,0,0,8007,0,0,8007,0
4780,A,7963,7961,0,1,0,0,7961,2
4780,C,8004,0,8003,0,0,1,8003,1
4781,G,7964,2,1,7961,0,0,7961,3
4781,T,8001,0,2,0,0,7985,7985,16
4782,A,7945,7944,0,0,0,1,7944,1
4782,T,7995,0,0,0,0,7995,7995,0
4783,G,7951,0,0,7950,0,0,7950,1
4783,T,7984,0,0,0,0,7984,7984,0
4784,A,8000,7999,0,1,0,0,7999,1
4784,C,7948,1,7946,0,0,1,7946,2
4785,G,7956,0,0,7956,0,0,7956,0
4785,T,8001,1,0,0,0,7989,7989,12
4786,T,7956,0,1,0,0,7953,7953,3
4786,T,8002,0,0,0,0,8002,8002,0
4787,C,7954,0,7953,0,0,1,7953,1
4787,T,8001,0,0,1,0,8000,8000,1
4788,G,7953,2,0,7951,0,0,7951,2
4788,G,7993,1,0,7992,0,0,7992,1
4789,A,7960,7959,0,0,0,0,7959,1
4789,T,7991,0,0,0,0,7991,7991,0
4790,A,7959,7958,1,0,0,0,7958,1
4790,A,7994,7991,0,0,0,0,7991,3
4791,A,7998,7998,0,0,0,0,7998,0
4791,G,7962,2,0,7959,0,0,7959,3
4792,C,7957,0,7956,0,0,0,7956,1
4792,C,8000,0,7998,0,0,0,7998,2
4793,C,7983,0,7982,0,0,1,7982,1
4793,G,7955,0,0,7872,0,0,7872,83
4794,A,7995,7993,0,0,0,0,7993,2
4794,G,7951,0,0,7951,0,0,7951,0
4795,G,7951,1,0,7950,0,0,7950,1
4795,T,7998,0,0,0,0,7998,7998,0
4796,G,7952,0,0,7952,0,0,7952,0
4796,T,7999,1,1,0,0,7997,7997,2
4797,A,7999,7996,0,1,0,0,7996,3
4797,G,7952,2,0,7950,0,0,7950,2
4798,C,7952,0,7951,0,0,0,7951,1
4798,T,8000,1,1,0,0,7997,7997,3
4799,A,8001,7998,0,0,0,1,7998,3
4799,G,7953,2,0,7947,0,1,7947,6
4800,A,8000,7999,0,1,0,0,7999,1
4800,G,7963,3,0,7960,0,0,7960,3
4801,G,7980,0,0,7980,0,0,7980,0
4801,T,7963,0,1,0,0,7960,7960,3
4802,C,7982,1,7979,0,0,2,7979,3
4802,G,7964,4,0,7960,0,0,7960,4
4803,T,7944,0,0,0,0,7944,7944,0
4803,T,7959,0,1,0,0,7954,7954,5
4804,G,7996,3,0,7993,0,0,7993,3
4804,T,7962,0,2,0,0,7959,7959,3
4805,C,7960,0,7959,0,0,1,7959,1
4805,C,8000,0,7997,0,0,2,7997,3
4806,A,8000,7996,2,0,0,1,7996,4
4806,G,7962,1,0,7961,0,0,7961,1
4807,A,8001,7999,0,1,0,0,7999,2
4807,C,7964,0,7959,0,0,0,7959,5
4808,C,7964,0,7964,0,0,0,7964,0
4808,T,8000,0,0,0,0,8000,8000,0
4809,A,8002,7986,0,1,0,0,7986,16
4809,G,7958,0,0,7957,0,0,7957,1
4810,A,7959,7959,0,0,0,0,7959,0
4810,A,8003,8003,0,0,0,0,8003,0
4811,A,8003,8003,0,0,0,0,8003,0
4811,G,7960,0,0,7959,0,1,7959,1
4812,A,7960,7959,0,0,0,0,7959,1
4812,C,8004,0,8004,0,0,0,8004,0
4813,A,7993,7985,0,1,0,0,7985,8
4813,T,7960,0,0,0,0,7960,7960,0
4814,A,7998,7997,0,0,0,1,7997,1
4814,C,7953,0,7953,0,0,0,7953,0
4815,G,7954,1,1,7950,0,0,7950,4
4815,G,8000,0,0,7996,0,3,7996,4
4816,G,7964,1,0,7963,0,0,7963,1
4816,T,8000,0,1,1,0,7993,7993,7
4817,C,7965,1,7937,1,0,0,7937,28
4817,T,8000,0,0,0,0,8000,8000,0
4818,C,7966,0,7966,0,0,0,7966,0
4818,G,7984,0,0,7947,0,0,7947,37
4819,C,7962,0,7961,1,0,0,7961,1
4819,G,7991,0,0,7991,0,0,7991,0
4820,G,7964,0,1,7963,0,0,7963,1
4820,G,7994,0,0,7994,0,0,7994,0
4821,C,7965,0,7962,0,0,1,7962,3
4821,G,7994,0,0,7991,0,2,7991,3
4822,G,7965,5,0,7959,0,0,7959,6
4822,T,7987,0,0,2,0,7984,7984,3
4823,C,7965,0,7964,0,0,1,7964,1
4823,G,7999,0,0,7978,0,1,7978,21
4824,A,7964,7960,1,0,0,0,7960,4
4824,G,7994,0,0,7994,0,0,7994,0
4825,G,8000,1,0,7998,0,1,7998,2
4825,T,7958,1,1,0,0,7955,7955,3
4826,C,8000,0,7998,0,0,2,7998,2
4826,G,7959,0,0,7951,0,1,7951,8
4827,G,7964,3,0,7960,0,0,7960,4
4827,G,7999,0,0,7998,0,0,7998,1
4828,A,7998,7994,0,0,0,0,7994,4
4828,C,7963,0,7950,0,0,2,7950,13
4829,A,7999,7998,0,0,0,1,7998,1
4829,C,7949,1,7947,0,0,1,7947,2
4830,G,7963,1,0,7962,0,0,7962,1
4830,G,8000,0,0,7999,0,1,7999,1
4831,A,7964,7963,0,0,0,0,7963,1
4831,A,8001,7999,0,1,0,0,7999,2
4832,A,8000,7999,1,0,0,0,7999,1
4832,G,7965,0,0,7964,0,1,7964,1
4833,C,8000,1,7999,0,0,0,7999,1
4833,T,7964,0,0,0,0,7956,7956,8
4834,T,7960,0,0,0,0,7960,7960,0
4834,T,7994,0,0,0,0,7993,7993,1
4835,C,8000,0,7995,0,0,0,7995,5
4835,G,7964,2,0,7962,0,0,7962,2
4836,A,7956,7956,0,0,0,0,7956,0
4836,C,8001,0,7999,0,0,2,7999,2
4837,A,8000,8000,0,0,0,0,8000,0
4837,G,7956,0,0,7956,0,0,7956,0
4838,C,7956,0,7954,1,0,1,7954,2
4838,G,8001,0,0,8000,0,0,8000,1
4839,C,7997,0,7997,0,0,0,7997,0
4839,G,7953,0,1,7947,0,0,7947,6
4840,A,7997,7996,1,0,0,0,7996,1
4840,G,7963,1,0,7962,0,0,7962,1
4841,T,7957,0,0,0,0,7954,7954,3
4841,T,7995,0,1,0,0,7994,7994,1
4842,G,7993,1,0,7992,0,0,7992,1
4842,T,7958,0,1,0,0,7956,7956,2
4843,A,7996,7994,0,1,0,1,7994,2
4843,C,7958,0,7926,0,0,0,7926,32
4844,C,7956,0,7956,0,0,0,7956,0
4844,G,7999,0,0,7999,0,0,7999,0
4845,A,7999,7997,0,2,0,0,7997,2
4845,C,7956,0,7955,0,0,1,7955,1
4846,G,7955,0,0,7950,0,0,7950,5
4846,T,7995,0,0,0,0,7995,7995,0
4847,C,7995,0,7922,0,0,0,7922,73
4847,G,7955,1,0,7954,0,0,7954,1
4848,C,7956,0,7954,1,0,1,7954,2
4848,C,7996,0,7995,0,0,1,7995,1
4849,C,7999,1,7998,0,0,0,7998,1
4849,T,7902,0,3,1,0,7896,7896,6
4850,C,7997,0,7993,2,0,2,7993,4
4850,G,7902,0,0,7890,0,0,7890,12
4851,G,7903,0,1,7897,0,0,7897,6
4851,G,8000,0,0,8000,0,0,8000,0
4852,C,7898,0,7890,1,0,2,7890,8
4852,C,8000,0,7998,0,0,2,7998,2
4853,C,7901,0,7898,1,0,1,7898,3
4853,G,7999,0,0,7998,0,0,7998,1
4854,C,8000,0,7998,1,0,0,7998,2
4854,G,7901,1,1,7898,0,0,7898,3
4855,C,7917,0,7915,0,0,1,7915,2
4855,T,7998,0,1,0,0,7997,7997,1
4856,G,7917,4,0,7912,0,0,7912,5
4856,G,8000,1,0,7997,0,0,7997,3
4857,C,7922,0,7919,0,0,1,7919,3
4857,G,8001,1,0,8000,0,0,8000,1
4858,A,7921,7919,0,2,0,0,7919,2
4858,A,8002,7998,0,0,0,1,7998,4
4859,G,7959,0,0,7959,0,0,7959,0
4859,G,8003,0,0,7998,0,0,7998,5
4860,C,7961,0,7960,0,0,1,7960,1
4860,G,8003,0,0,8003,0,0,8003,0
4861,A,7963,7957,0,0,0,0,7957,6
4861,A,8002,8000,0,1,0,0,8000,2
4862,A,7964,7963,0,1,0,0,7963,1
4862,T,8000,0,1,0,0,7999,7999,1
4863,C,7964,0,7963,0,0,1,7963,1
4863,C,7985,0,7983,0,0,2,7983,2
4864,A,7957,7955,0,1,0,0,7955,2
4864,A,7989,7987,1,0,0,1,7987,2
4865,G,7964,0,0,7963,0,0,7963,1
4865,T,7997,0,0,0,0,7996,7996,1
4866,A,7963,7962,0,0,0,0,7962,1
4866,C,7994,0,7987,1,0,0,7987,7
4867,C,7994,0,7993,1,0,0,7993,1
4867,T,7963,0,1,0,0,7962,7962,1
4868,A,7988,7986,0,2,0,0,7986,2
4868,G,7947,1,0,7943,0,0,7943,4
4869,G,7949,0,0,7949,0,0,7949,0
4869,G,7989,0,0,7989,0,0,7989,0
4870,A,7947,7944,0,1,0,2,7944,3
4870,C,7989,0,7978,0,0,0,7978,11
4871,C,7987,1,7984,0,0,0,7984,3
4871,G,7948,1,0,7924,0,0,7924,24
4872,G,7937,0,0,7937,0,0,7937,0
4872,G,7978,0,0,7973,0,0,7973,5
4873,G,7955,0,1,7954,0,0,7954,1
4873,G,7983,0,0,7983,0,0,7983,0
4874,C,7953,0,7948,0,0,1,7948,5
4874,C,7982,1,7978,0,0,3,7978,4
4875,C,7946,0,7946,0,0,0,7946,0
4875,G,7985,1,1,7982,0,0,7982,3
4876,T,7964,0,0,0,0,7962,7962,2
4876,T,7985,0,2,1,0,7982,7982,3
4877,C,7965,0,7960,0,0,1,7960,5
4877,C,7993,0,7913,0,0,1,7913,80
4878,C,7965,1,7962,0,0,2,7962,3
4878,C,8000,1,7998,0,0,1,7998,2
4879,C,7999,0,7998,0,0,0,7998,1
4879,T,7963,0,2,0,0,7960,7960,3
4880,G,7961,1,0,7952,0,1,7952,9
4880,G,7999,0,0,7992,0,0,7992,7
4881,G,7963,1,0,7960,0,1,7960,3
4881,G,8001,1,0,7999,0,0,7999,2
4882,A,8000,7969,0,1,0,0,7969,31
4882,C,7960,0,7956,0,0,2,7956,4
4883,A,8002,8002,0,0,0,0,8002,0
4883,G,7957,0,0,7957,0,0,7957,0
4884,A,7998,7997,0,1,0,0,7997,1
4884,C,7958,1,7957,0,0,0,7957,1
4885,A,7998,7998,0,0,0,0,7998,0
4885,C,7950,2,7948,0,0,0,7948,2
4886,C,8000,0,7998,0,0,2,7998,2
4886,G,7963,0,0,7963,0,0,7963,0
4887,C,7963,0,7961,0,0,1,7961,2
4887,G,7996,0,0,7995,0,1,7995,1
4888,A,7964,7963,0,1,0,0,7963,1
4888,A,8000,7999,0,0,0,0,7999,1
4889,C,7964,0,7956,0,0,3,7956,8
4889,T,8001,1,0,0,0,7997,7997,4
4890,C,7955,0,7954,0,0,1,7954,1
4890,T,8002,0,0,0,0,8002,8002,0
4891,C,8002,0,7985,0,0,0,7985,17
4891,G,7964,1,0,7956,0,0,7956,8
4892,C,8001,0,7998,1,0,2,7998,3
4892,G,7965,1,2,7961,0,0,7961,4
4893,C,7964,1,7939,0,0,0,7939,25
4893,G,8001,1,0,8000,0,0,8000,1
4894,A,8002,7997,1,0,0,0,7997,5
4894,C,7964,0,7963,0,0,1,7963,1
4895,A,8002,8001,0,1,0,0,8001,1
4895,C,7962,1,7961,0,0,0,7961,1
4896,A,7962,7957,0,0,0,0,7957,5
4896,G,8003,0,0,8003,0,0,8003,0
4897,A,7962,7962,0,0,0,0,7962,0
4897,C,8001,0,7972,0,0,0,7972,29
4898,C,8002,1,8001,0,0,0,8001,1
4898,G,7962,1,0,7956,0,0,7956,6
4899,C,8002,0,8002,0,0,0,8002,0
4899,G,7964,0,0,7963,0,1,7963,1
4900,A,7927,7926,0,0,0,0,7926,1
4900,A,8001,7992,0,1,0,0,7992,9
4901,A,8002,8001,0,0,0,0,8001,1
4901,G,7924,0,0,7924,0,0,7924,0
4902,C,7926,0,7906,0,0,0,7906,20
4902,C,8002,0,7997,0,0,0,7997,5
4903,C,7927,0,7926,1,0,0,7926,1
4903,C,8003,0,8002,0,0,0,8002,1
4904,C,7923,0,7920,1,0,2,7920,3
4904,T,8002,0,0,0,0,7985,7985,17
4905,G,7934,3,1,7928,0,0,7928,6
4905,T,7998,1,0,0,0,7997,7997,1
4906,C,7939,0,7938,0,0,1,7938,1
4906,T,8000,0,0,0,0,8000,8000,0
4907,C,8001,0,8001,0,0,0,8001,0
4907,G,7939,0,0,7939,0,0,7939,0
4908,A,8002,8000,0,0,0,0,8000,2
4908,T,7940,0,0,0,0,7937,7937,3
4909,G,7940,0,0,7938,0,0,7938,2
4909,T,8002,0,0,0,0,8002,8002,0
4910,A,7994,7994,0,0,0,0,7994,0
4910,G,7963,0,0,7963,0,0,7963,0
4911,G,7999,0,0,7997,0,2,7997,2
4911,T,7962,0,0,0,0,7953,7953,9
4912,A,7982,7975,0,1,0,0,7975,7
4912,T,7961,0,0,0,0,7960,7960,1
4913,A,7983,7980,1,1,0,1,7980,3
4913,C,7962,0,7961,0,0,0,7961,1
4914,C,7961,0,7959,0,0,2,7959,2
4914,G,7980,0,1,7974,0,0,7974,6
4915,G,7979,0,2,7976,0,1,7976,3
4915,T,7962,0,0,0,0,7961,7961,1
4916,C,7979,2,7975,0,0,1,7975,4
4916,G,7963,0,0,7963,0,0,7963,0
4917,G,7961,0,0,7961,0,0,7961,0
4917,G,7977,0,0,7970,0,1,7970,7
4918,C,7960,0,7956,0,0,1,7956,4
4918,G,7978,0,1,7977,0,0,7977,1
4919,C,7946,0,7946,0,0,0,7946,0
4919,C,7978,0,7976,0,0,1,7976,2
4920,A,7937,7934,0,0,0,0,7934,3
4920,G,7978,1,0,7970,0,0,7970,8
4921,C,7942,0,7940,0,0,0,7940,2
4921,G,7984,3,0,7981,0,0,7981,3
4922,C,7939,1,7937,0,0,1,7937,2
4922,T,7983,0,1,0,0,7982,7982,1
4923,G,7944,0,0,7943,0,0,7943,1
4923,G,7985,0,0,7977,0,0,7977,8
4924,G,7987,0,0,7987,0,0,7987,0
4924,T,7945,0,1,1,0,7943,7943,2
4925,A,7991,7981,0,3,0,0,7981,10
4925,C,7944,0,7944,0,0,0,7944,0
4926,A,8000,8000,0,0,0,0,8000,0
4926,G,7944,0,0,7938,0,0,7938,6
4927,G,7946,0,0,7945,0,0,7945,1
4927,T,8000,0,0,0,0,8000,8000,0
4928,C,7953,0,7952,0,0,1,7952,1
4928,C,8000,0,7998,0,0,2,7998,2
4929,G,7955,0,0,7955,0,0,7955,0
4929,G,8001,1,0,7999,0,1,7999,2
4930,A,7997,7977,0,0,0,0,7977,20
4930,T,7949,0,0,1,0,7948,7948,1
4931,A,8000,8000,0,0,0,0,8000,0
4931,C,7950,0,7950,0,0,0,7950,0
4932,A,8001,8000,0,0,0,1,8000,1
4932,T,7955,0,0,0,0,7955,7955,0
4933,C,7957,0,7955,0,0,1,7955,2
4933,T,8002,0,1,0,0,8001,8001,1
4934,C,8002,0,8001,0,0,0,8001,1
4934,G,7957,0,0,7957,0,0,7957,0
4935,C,7963,0,7947,0,0,0,7947,16
4935,T,8001,0,1,0,0,8000,8000,1
4936,C,7962,0,7960,0,0,0,7960,2
4936,C,8002,0,8001,0,0,1,8001,1
4937,C,7958,0,7958,0,0,0,7958,0
4937,G,8003,2,0,8001,0,0,8001,2
4938,G,7958,0,0,7957,0,1,7957,1
4938,T,8004,0,0,0,0,8004,8004,0
4939,A,7961,7960,0,0,0,0,7960,1
4939,G,8005,0,0,8005,0,0,8005,0
4940,A,8004,8004,0,0,0,0,8004,0
4940,C,7964,0,7957,0,0,0,7957,7
4941,C,7965,0,7964,0,0,1,7964,1
4941,T,8005,0,0,0,0,8005,8005,0
4942,A,7964,7963,0,1,0,0,7963,1
4942,G,8004,0,0,7998,0,0,7998,6
4943,C,7965,0,7962,0,0,0,7962,3
4943,G,8005,1,1,8003,0,0,8003,2
4944,C,7961,0,7961,0,0,0,7961,0
4944,C,8006,0,8003,1,0,2,8003,3
4945,A,7960,7959,0,1,0,0,7959,1
4945,A,8002,8001,0,1,0,0,8001,1
4946,G,7964,1,0,7947,0,0,7947,17
4946,G,8003,0,0,7993,0,0,7993,10
4947,G,7965,0,0,7965,0,0,7965,0
4947,G,8004,0,0,8003,0,0,8003,1
4948,G,7965,1,0,7964,0,0,7964,1
4948,T,8003,1,0,1,0,7995,7995,8
4949,C,7961,0,7961,0,0,0,7961,0
4949,T,8002,0,0,0,0,8001,8001,1
4950,A,7952,7949,0,0,0,0,7949,3
4950,G,8003,0,0,7987,0,0,7987,16
4951,A,7954,7951,1,1,0,0,7951,3
4951,G,8002,0,0,8002,0,0,8002,0
4952,G,7953,1,0,7935,0,0,7935,18
4952,G,8003,1,0,8002,0,0,8002,1
4953,C,8002,0,8002,0,0,0,8002,0
4953,G,7964,0,0,7964,0,0,7964,0
4954,G,7965,1,0,7964,0,0,7964,1
4954,G,8001,1,0,7999,0,0,7999,2
4955,T,7939,0,0,1,0,7936,7936,3
4955,T,7998,0,0,2,0,7996,7996,2
4956,C,7938,0,7938,0,0,0,7938,0
4956,C,7991,0,7990,0,0,1,7990,1
4957,G,7994,1,0,7993,0,0,7993,1
4957,T,7929,1,1,0,0,7926,7926,3
4958,C,7998,0,7997,1,0,0,7997,1
4958,G,7951,0,0,7936,0,2,7936,15
4959,G,7952,0,1,7950,0,0,7950,2
4959,T,7998,0,0,0,0,7997,7997,1
4960,G,7950,1,1,7948,0,0,7948,2
4960,T,7995,0,0,0,0,7995,7995,0
4961,C,7950,0,7950,0,0,0,7950,0
4961,G,7996,0,0,7990,0,1,7990,6
4962,A,7873,7872,0,0,0,0,7872,1
4962,G,8000,1,0,7998,0,1,7998,2
4963,G,7879,0,0,7878,0,0,7878,1
4963,T,8001,0,0,1,0,8000,8000,1
4964,C,7879,0,7876,0,0,3,7876,3
4964,C,7993,0,7993,0,0,0,7993,0
4965,G,7882,0,0,7882,0,0,7882,0
4965,G,7993,1,0,7991,0,0,7991,2
4966,C,7891,0,7886,0,0,0,7886,5
4966,G,7998,2,0,7996,0,0,7996,2
4967,C,7885,0,7883,0,0,2,7883,2
4967,T,7997,0,0,0,0,7997,7997,0
4968,C,7998,0,7998,0,0,0,7998,0
4968,G,7922,1,0,7921,0,0,7921,1
4969,A,8000,8000,0,0,0,0,8000,0
4969,T,7922,0,2,0,0,7919,7919,3
4970,C,7924,0,7924,0,0,0,7924,0
4970,T,8001,0,0,0,0,7985,7985,16
4971,G,7927,3,0,7924,0,0,7924,3
4971,T,8002,0,1,0,0,8001,8001,1
4972,T,7926,0,0,0,0,7924,7924,2
4972,T,8003,0,1,0,0,8002,8002,1
4973,C,8003,0,8002,0,0,1,8002,1
4973,G,7929,2,0,7927,0,0,7927,2
4974,C,7930,0,7927,0,0,1,7927,3
4974,G,8004,0,0,8004,0,0,8004,0
4975,A,7993,7988,0,1,0,0,7988,5
4975,T,7927,0,7,1,0,7919,7919,8
4976,A,7995,7995,0,0,0,0,7995,0
4976,C,7960,1,7877,0,0,1,7877,83
4977,C,7945,0,7945,0,0,0,7945,0
4977,C,8000,0,7925,0,0,0,7925,75
4978,C,7962,0,7961,0,0,1,7961,1
4978,C,7995,0,7995,0,0,0,7995,0
4979,C,7962,1,7959,2,0,0,7959,3
4979,C,7999,0,7999,0,0,0,7999,0
4980,C,7999,0,7999,0,0,0,7999,0
4980,G,7958,2,0,7949,0,0,7949,9
4981,A,8000,7998,1,0,0,1,7998,2
4981,G,7964,1,0,7963,0,0,7963,1
4982,A,7964,7963,0,1,0,0,7963,1
4982,G,8001,1,0,8000,0,0,8000,1
4983,A,8001,8000,0,0,0,0,8000,1
4983,G,7964,0,0,7962,0,1,7962,2
4984,G,8002,0,0,8002,0,0,8002,0
4984,T,7962,0,0,0,0,7962,7962,0
4985,G,7942,0,0,7940,0,0,7940,2
4985,T,8003,0,0,0,0,8003,8003,0
4986,C,7990,0,7966,0,0,0,7966,24
4986,G,7942,1,0,7941,0,0,7941,1
4987,A,7936,7936,0,0,0,0,7936,0
4987,C,7992,0,7991,0,0,1,7991,1
4988,C,7975,0,7974,0,0,1,7974,1
4988,G,7937,1,0,7933,0,1,7933,4
4989,G,7928,2,0,7926,0,0,7926,2
4989,G,7999,1,0,7997,0,0,7997,2
4990,C,7931,0,7925,0,0,1,7925,6
4990,C,7999,0,7999,0,0,0,7999,0
4991,C,7928,0,7927,0,0,0,7927,1
4991,T,7998,0,0,0,0,7998,7998,0
4992,C,8000,0,7998,0,0,1,7998,2
4992,G,7922,1,0,7919,0,0,7919,3
4993,A,7995,7994,0,0,0,0,7994,1
4993,C,7923,0,7911,1,0,1,7911,12
4994,C,7923,0,7922,0,0,1,7922,1
4994,G,7999,0,0,7999,0,0,7999,0
4995,A,7999,7996,0,0,0,0,7996,3
4995,G,7924,0,1,7923,0,0,7923,1
4996,A,7922,7921,0,0,0,0,7921,1
4996,A,8000,7999,0,0,0,1,7999,1
4997,G,7924,0,0,7922,0,0,7922,2
4997,G,8001,1,0,7999,0,0,7999,2
4998,A,7979,7977,1,0,0,0,7977,2
4998,C,7922,0,7921,0,0,1,7921,1
4999,A,7981,7981,0,0,0,0,7981,0
4999,G,7938,1,0,7936,0,0,7936,2
5000,C,7947,0,7945,0,0,1,7945,2
5000,C,7999,0,7998,0,0,0,7998,1
5001,G,7944,1,0,7943,0,0,7943,1
5001,T,7985,0,0,0,0,7985,7985,0
5002,C,7950,0,7942,0,0,1,7942,8
5002,C,8000,0,7998,0,0,1,7998,2
5003,C,7951,0,7949,1,0,0,7949,2
5003,G,7996,0,0,7996,0,0,7996,0
5004,G,7953,0,1,7893,0,0,7893,60
5004,T,8000,0,0,0,0,8000,8000,0
5005,C,8001,0,7999,0,0,2,7999,2
5005,G,7953,0,0,7953,0,0,7953,0
5006,A,8000,7993,0,1,0,0,7993,7
5006,G,7955,1,0,7954,0,0,7954,1
5007,A,8001,7999,0,1,0,1,7999,2
5007,G,7964,1,0,7963,0,0,7963,1
5008,G,8002,0,0,8001,0,1,8001,1
5008,T,7961,0,0,0,0,7961,7961,0
5009,A,7996,7991,0,0,0,0,7991,5
5009,G,7953,3,0,7950,0,0,7950,3
5010,A,7999,7998,0,1,0,0,7998,1
5010,C,7954,0,7942,0,0,1,7942,12
5011,C,7956,1,7952,0,0,3,7952,4
5011,G,7982,0,0,7977,0,1,7977,5
5012,C,7956,0,7954,1,0,1,7954,2
5012,G,7982,1,0,7981,0,0,7981,1
5013,C,7984,1,7981,0,0,2,7981,3
5013,G,7954,1,2,7951,0,0,7951,3
5014,C,7964,0,7960,1,0,1,7960,4
5014,G,7987,0,0,7987,0,0,7987,0
5015,A,8000,7999,0,1,0,0,7999,1
5015,C,7964,2,7962,0,0,0,7962,2
5016,T,7961,1,0,0,0,7957,7957,4
5016,T,8001,0,0,0,0,8001,8001,0
5017,A,8002,8000,0,2,0,0,8000,2
5017,T,7964,0,0,0,0,7964,7964,0
5018,C,7965,0,7960,0,0,0,7960,5
5018,G,8003,0,0,8002,0,1,8002,1
5019,A,8001,7996,0,2,0,0,7996,5
5019,C,7966,0,7966,0,0,0,7966,0
5020,A,7995,7995,0,0,0,0,7995,0
5020,T,7963,0,2,0,0,7961,7961,2
5021,G,7964,0,0,7963,0,0,7963,1
5021,G,7997,0,0,7992,0,1,7992,5
5022,G,7964,0,0,7964,0,0,7964,0
5022,G,8000,1,0,7999,0,0,7999,1
5023,A,7946,7946,0,0,0,0,7946,0
5023,C,7998,0,7996,0,0,1,7996,2
5024,G,7948,0,0,7947,0,1,7947,1
5024,G,7983,2,0,7981,0,0,7981,2
5025,A,7933,7933,0,0,0,0,7933,0
5025,A,7985,7983,1,1,0,0,7983,2
5026,C,7946,0,7944,0,0,0,7944,2
5026,T,7984,0,0,0,0,7984,7984,0
5027,C,7936,0,7935,0,0,1,7935,1
5027,G,7989,1,0,7987,0,1,7987,2
5028,C,7989,0,7986,0,0,3,7986,3
5028,T,7933,0,0,0,0,7933,7933,0
5029,C,7932,1,7926,0,0,0,7926,6
5029,G,7994,0,1,7992,0,0,7992,2
5030,C,7930,0,7929,0,0,0,7929,1
5030,C,8000,0,7996,1,0,1,7996,4
5031,G,7929,1,0,7926,0,1,7926,3
5031,T,7997,0,0,0,0,7997,7997,0
5032,C,7931,0,7928,0,0,2,7928,3
5032,G,8000,3,0,7996,0,0,7996,4
5033,C,8001,0,8000,0,0,1,8000,1
5033,G,7927,0,1,7924,0,0,7924,3
5034,C,7946,1,7904,1,0,1,7904,42
5034,G,8001,3,0,7998,0,0,7998,3
5035,A,8002,7999,0,0,0,0,7999,3
5035,C,7933,0,7932,0,0,1,7932,1
5036,A,8001,8001,0,0,0,0,8001,0
5036,C,7941,0,7941,0,0,0,7941,0
5037,C,7941,0,7940,0,0,1,7940,1
5037,T,8001,0,0,0,0,8000,8000,1
5038,C,7999,0,7997,1,0,1,7997,2
5038,G,7941,1,0,7940,0,0,7940,1
5039,C,7946,0,7942,0,0,3,7942,4
5039,G,7998,2,0,7948,0,1,7948,50
5040,A,7945,7939,0,1,0,0,7939,6
5040,G,7999,2,0,7997,0,0,7997,2
5041,A,7951,7951,0,0,0,0,7951,0
5041,G,7999,1,0,7998,0,0,7998,1
5042,A,7998,7998,0,0,0,0,7998,0
5042,C,7955,0,7951,0,0,0,7951,4
5043,C,7949,0,7948,0,0,1,7948,1
5043,G,7998,0,0,7997,0,0,7997,1
5044,C,7995,0,7994,1,0,0,7994,1
5044,T,7949,0,5,0,0,7942,7942,7
5045,C,7956,0,7878,0,0,0,7878,78
5045,G,7995,2,1,7986,0,0,7986,9
5046,C,7962,0,7961,0,0,1,7961,1
5046,G,8000,0,0,8000,0,0,8000,0
5047,C,7964,0,7964,0,0,0,7964,0
5047,C,7999,0,7998,0,0,1,7998,1
5048,C,7963,0,7962,0,0,1,7962,1
5048,G,7999,0,0,7999,0,0,7999,0
5049,A,7997,7996,0,1,0,0,7996,1
5049,T,7964,0,0,0,0,7962,7962,2
5050,T,7962,0,0,0,0,7962,7962,0
5050,T,7997,0,0,0,0,7996,7996,1
5051,A,7999,7998,0,0,0,0,7998,1
5051,C,7962,0,7960,0,0,2,7960,2
5052,C,8000,0,7994,0,0,0,7994,6
5052,T,7957,0,0,0,0,7954,7954,3
5053,A,7956,7955,0,1,0,0,7955,1
5053,C,7987,0,7985,0,0,1,7985,2
5054,C,7953,0,7952,0,0,1,7952,1
5054,G,7998,4,0,7992,0,0,7992,6
5055,G,7952,0,0,7951,0,0,7951,1
5055,T,7991,0,0,0,0,7989,7989,2
5056,A,7947,7945,0,0,0,1,7945,2
5056,A,7992,7984,0,0,0,2,7984,8
5057,A,7999,7998,0,1,0,0,7998,1
5057,G,7947,0,0,7946,0,0,7946,1
5058,A,7998,7997,0,0,0,1,7997,1
5058,C,7943,0,7940,1,0,2,7940,3
5059,G,7936,0,1,7930,0,0,7930,6
5059,G,7999,0,0,7998,0,0,7998,1
5060,C,7994,0,7994,0,0,0,7994,0
5060,G,7944,3,0,7941,0,0,7941,3
5061,A,7987,7986,0,1,0,0,7986,1
5061,C,7946,0,7945,0,0,1,7945,1
5062,C,7998,1,7995,0,0,2,7995,3
5062,T,7946,0,0,0,0,7946,7946,0
5063,C,7954,1,7951,0,0,0,7951,3
5063,G,7994,1,0,7992,0,1,7992,2
5064,A,7999,7998,0,1,0,0,7998,1
5064,G,7953,0,0,7946,0,1,7946,7
5065,G,7963,0,0,7963,0,0,7963,0
5065,G,7999,1,0,7988,0,0,7988,11
5066,C,7965,0,7964,0,0,1,7964,1
5066,G,7999,1,0,7998,0,0,7998,1
5067,A,7999,7997,0,1,0,0,7997,2
5067,T,7964,2,0,2,0,7959,7959,5
5068,A,7990,7990,0,0,0,0,7990,0
5068,T,7962,0,0,0,0,7961,7961,1
5069,C,7954,0,7953,0,0,1,7953,1
5069,G,7996,0,0,7995,0,0,7995,1
5070,A,7953,7950,0,2,0,0,7950,3
5070,C,7995,0,7993,0,0,1,7993,2
5071,C,7956,0,7951,0,0,2,7951,5
5071,G,7997,1,0,7990,0,0,7990,7
5072,C,7952,1,7950,0,0,1,7950,2
5072,G,8000,0,0,8000,0,0,8000,0
5073,G,7957,0,0,7957,0,0,7957,0
5073,T,7995,0,0,0,0,7995,7995,0
5074,C,7996,0,7996,0,0,0,7996,0
5074,T,7952,0,0,1,0,7950,7950,2
5075,A,7992,7991,0,0,0,0,7991,1
5075,C,7952,0,7950,0,0,2,7950,2
5076,A,7953,7951,0,2,0,0,7951,2
5076,G,8000,1,0,7998,0,0,7998,2
5077,C,7954,0,7953,0,0,0,7953,1
5077,C,8000,0,7953,0,0,2,7953,47
5078,C,7951,0,7949,1,0,0,7949,2
5078,C,8000,0,7999,0,0,1,7999,1
5079,C,7996,0,7996,0,0,0,7996,0
5079,G,7950,1,2,7947,0,0,7947,3
5080,A,7993,7992,0,1,0,0,7992,1
5080,C,7949,0,7943,1,0,1,7943,6
5081,C,7948,0,7948,0,0,0,7948,0
5081,T,7993,1,1,0,0,7985,7985,8
5082,G,7946,1,0,7945,0,0,7945,1
5082,T,7992,0,1,0,0,7991,7991,1
5083,A,7956,7955,0,0,0,0,7955,1
5083,C,7991,0,7988,0,0,3,7988,3
5084,C,7957,0,7956,0,0,0,7956,1
5084,G,7991,0,0,7990,0,1,7990,1
5085,C,7997,0,7992,0,0,0,7992,5
5085,G,7958,1,0,7957,0,0,7957,1
5086,C,7993,0,7991,1,0,1,7991,2
5086,T,7955,1,0,0,0,7953,7953,2
5087,C,7956,0,7956,0,0,0,7956,0
5087,G,8000,0,3,7997,0,0,7997,3
5088,C,8000,0,7998,0,0,0,7998,2
5088,G,7959,0,0,7959,0,0,7959,0
5089,A,7959,7957,1,1,0,0,7957,2
5089,C,7999,1,7997,0,0,0,7997,2
5090,A,7998,7996,1,0,0,0,7996,2
5090,G,7959,1,0,7954,0,1,7954,5
5091,A,7999,7996,0,3,0,0,7996,3
5091,G,7963,1,0,7962,0,0,7962,1
5092,G,8000,0,0,8000,0,0,8000,0
5092,T,7953,0,0,1,0,7950,7950,3
5093,C,8002,0,8002,0,0,0,8002,0
5093,G,7963,0,0,7962,0,1,7962,1
5094,C,7961,0,7945,0,0,0,7945,16
5094,T,7999,0,0,0,0,7998,7998,1
5095,C,7962,0,7961,0,0,1,7961,1
5095,C,8000,0,8000,0,0,0,8000,0
5096,C,7962,2,7959,0,0,1,7959,3
5096,T,7997,0,0,0,0,7992,7992,5
5097,G,7963,1,0,7962,0,0,7962,1
5097,T,7997,0,1,0,0,7996,7996,1
5098,A,7964,7962,0,1,0,0,7962,2
5098,C,8000,0,7998,0,0,2,7998,2
5099,A,7964,7963,0,1,0,0,7963,1
5099,A,7999,7998,0,1,0,0,7998,1
5100,G,7963,0,0,7955,0,2,7955,8
5100,G,8000,0,0,7999,0,0,7999,1
5101,C,7999,0,7997,0,0,2,7997,2
5101,G,7964,0,0,7964,0,0,7964,0
5102,A,7949,7948,0,1,0,0,7948,1
5102,A,7985,7981,0,1,0,0,7981,4
5103,A,8000,8000,0,0,0,0,8000,0
5103,C,7953,0,7946,0,0,0,7946,7
5104,C,7935,0,7935,0,0,0,7935,0
5104,T,7992,0,0,0,0,7991,7991,1
5105,A,7999,7998,0,0,0,1,7998,1
5105,G,7942,2,0,7940,0,0,7940,2
5106,C,7948,0,7948,0,0,0,7948,0
5106,T,7999,0,0,0,0,7999,7999,0
5107,C,7993,0,7990,0,0,3,7990,3
5107,G,7951,1,0,7949,0,0,7949,2
5108,A,7993,7990,1,2,0,0,7990,3
5108,C,7963,0,7963,0,0,0,7963,0
5109,A,7963,7961,1,0,0,0,7961,2
5109,C,7995,1,7991,0,0,1,7991,4
5110,C,7965,0,7959,0,0,1,7959,6
5110,G,7993,0,0,7980,0,0,7980,13
5111,C,7962,0,7960,0,0,2,7960,2
5111,G,7995,1,0,7994,0,0,7994,1
5112,G,7989,0,0,7989,0,0,7989,0
5112,T,7960,0,0,0,0,7960,7960,0
5113,G,7964,2,0,7956,0,2,7956,8
5113,T,7986,0,0,0,0,7986,7986,0
5114,A,7992,7992,0,0,0,0,7992,0
5114,G,7965,0,0,7965,0,0,7965,0
5115,G,8000,2,0,7998,0,0,7998,2
5115,T,7963,0,0,0,0,7963,7963,0
5116,C,8000,0,7997,0,0,2,7997,3
5116,G,7963,0,0,7963,0,0,7963,0
5117,C,7943,0,7941,0,0,2,7941,2
5117,C,8001,1,7999,0,0,0,7999,2
5118,A,7942,7941,1,0,0,0,7941,1
5118,A,7992,7981,2,0,0,0,7981,11
5119,A,8000,7998,2,0,0,0,7998,2
5119,T,7912,0,1,0,0,7911,7911,1
5120,C,8000,0,7999,0,0,1,7999,1
5120,G,7911,0,0,7910,0,0,7910,1
5121,A,7922,7921,0,0,0,0,7921,1
5121,G,8000,0,1,7998,0,0,7998,2
5122,C,7929,0,7913,0,0,1,7913,16
5122,C,8001,0,8000,0,0,0,8000,1
5123,C,7941,0,7941,0,0,0,7941,0
5123,T,7983,2,2,1,0,7977,7977,6
5124,A,7994,7992,0,0,0,1,7992,2
5124,C,7938,0,7935,3,0,0,7935,3
5125,G,7936,1,3,7931,0,1,7931,5
5125,T,8000,1,0,0,0,7999,7999,1
5126,C,7936,0,7936,0,0,0,7936,0
5126,G,8000,0,0,7998,0,1,7998,2
5127,A,7936,7928,0,1,0,0,7928,8
5127,T,7998,0,0,0,0,7998,7998,0
5128,A,7935,7934,0,1,0,0,7934,1
5128,C,7987,1,7982,0,0,0,7982,5
5129,C,7982,1,7978,0,0,3,7978,4
5129,G,7945,1,0,7944,0,0,7944,1
5130,C,7947,0,7893,0,0,1,7893,54
5130,T,7973,0,0,1,0,7972,7972,1
5131,C,7943,0,7942,1,0,0,7942,1
5131,G,7974,2,0,7972,0,0,7972,2
5132,A,7978,7978,0,0,0,0,7978,0
5132,C,7936,0,7936,0,0,0,7936,0
5133,G,7933,1,0,7924,0,0,7924,9
5133,T,7976,0,0,0,0,7976,7976,0
5134,A,7971,7969,0,0,0,1,7969,2
5134,G,7956,0,0,7955,0,0,7955,1
5135,G,7966,0,0,7965,0,0,7965,1
5135,T,7955,0,0,0,0,7955,7955,0
5136,C,7945,0,7943,0,0,2,7943,2
5136,G,7964,2,0,7962,0,0,7962,2
5137,C,7964,0,7953,0,0,1,7953,11
5137,G,7932,0,0,7925,0,0,7925,7
5138,C,7958,2,7956,0,0,0,7956,2
5138,G,7942,2,0,7940,0,0,7940,2
5139,T,7936,0,0,0,0,7933,7933,3
5139,T,7953,0,1,0,0,7952,7952,1
5140,A,7963,7960,0,1,0,1,7960,3
5140,C,7995,0,7984,0,0,2,7984,11
5141,C,7994,0,7993,1,0,0,7993,1
5141,G,7963,0,0,7961,0,0,7961,2
5142,G,7964,0,0,7964,0,0,7964,0
5142,G,7999,2,1,7996,0,0,7996,3
5143,C,7953,0,7950,0,0,0,7950,3
5143,C,8000,0,7994,0,0,1,7994,6
5144,C,8000,2,7995,0,0,2,7995,5
5144,T,7951,0,1,0,0,7950,7950,1
5145,A,7928,7925,1,0,0,0,7925,3
5145,A,7999,7996,1,1,0,0,7996,3
5146,C,8001,0,8000,0,0,1,8000,1
5146,G,7963,1,0,7961,0,0,7961,2
5147,A,8000,7999,0,0,0,0,7999,1
5147,T,7961,0,0,0,0,7961,7961,0
5148,A,7964,7963,0,0,0,0,7963,1
5148,C,8001,0,7984,0,0,0,7984,17
5149,C,7991,2,7988,0,0,0,7988,3
5149,T,7962,0,1,1,0,7957,7957,5
5150,C,7996,0,7995,0,0,1,7995,1
5150,G,7923,0,0,7922,0,1,7922,1
5151,A,7987,7984,2,1,0,0,7984,3
5151,T,7917,0,1,0,0,7915,7915,2
5152,A,7905,7901,0,1,0,1,7901,4
5152,G,7998,1,1,7996,0,0,7996,2
5153,A,7940,7940,0,0,0,0,7940,0
5153,C,8001,0,7986,1,0,0,7986,15
5154,C,7997,0,7997,0,0,0,7997,0
5154,G,7956,0,0,7956,0,0,7956,0
5155,C,7942,0,7931,0,0,1,7931,11
5155,G,8000,0,1,7996,0,0,7996,4
5156,C,7929,1,7927,0,0,1,7927,2
5156,G,7999,0,0,7999,0,0,7999,0
5157,C,8000,0,7986,1,0,1,7986,14
5157,T,7892,0,0,0,0,7891,7891,1
5158,A,7896,7896,0,0,0,0,7896,0
5158,C,8000,2,7996,1,0,0,7996,4
5159,A,7997,7994,1,0,0,0,7994,3
5159,G,7960,0,0,7960,0,0,7960,0
5160,C,7999,0,7999,0,0,0,7999,0
5160,T,7959,0,0,0,0,7959,7959,0
5161,A,7995,7995,0,0,0,0,7995,0
5161,C,7959,0,7957,0,0,0,7957,2
5162,G,7999,1,0,7998,0,0,7998,1
5162,T,7953,0,1,0,0,7950,7950,3
5163,T,7940,0,0,0,0,7940,7940,0
5163,T,7999,0,1,0,0,7997,7997,2
5164,A,7943,7943,0,0,0,0,7943,0
5164,C,7998,1,7996,0,0,1,7996,2
5165,G,7946,0,0,7946,0,0,7946,0
5165,G,7999,2,0,7997,0,0,7997,2
5166,A,7947,7946,0,1,0,0,7946,1
5166,A,8000,7999,0,0,0,0,7999,1
5167,T,7961,0,0,0,0,7960,7960,1
5167,T,7999,1,2,0,0,7996,7996,3
5168,A,7906,7899,0,0,0,0,7899,7
5168,G,8001,0,0,8000,0,0,8000,1
5169,A,7910,7909,0,1,0,0,7909,1
5169,A,7996,7989,0,0,0,0,7989,7
5170,A,7999,7998,0,0,0,1,7998,1
5170,T,7916,1,0,0,0,7915,7915,1
5171,A,7916,7893,0,1,0,0,7893,23
5171,T,7985,0,0,0,0,7984,7984,1
5172,A,7920,7919,0,1,0,0,7919,1
5172,C,7993,0,7989,0,0,0,7989,4
5173,A,7916,7916,0,0,0,0,7916,0
5173,C,7994,0,7993,0,0,1,7993,1
5174,A,7916,7915,1,0,0,0,7915,1
5174,A,7994,7991,1,1,0,0,7991,3
5175,G,7994,0,0,7994,0,0,7994,0
5175,T,7924,0,0,1,0,7923,7923,1
5176,A,7994,7942,0,3,0,0,7942,52
5176,C,7915,1,7913,0,0,1,7913,2
5177,A,7992,7992,0,0,0,0,7992,0
5177,G,7917,0,0,7916,0,1,7916,1
5178,A,7992,7992,0,0,0,0,7992,0
5178,C,7917,0,7915,1,0,0,7915,2
5179,A,7974,7974,0,0,0,0,7974,0
5179,T,7915,0,2,0,0,7913,7913,2
5180,A,7930,7929,0,0,0,0,7929,1
5180,G,7975,0,0,7975,0,0,7975,0
5181,C,7972,0,7971,0,0,0,7971,1
5181,T,7930,0,0,1,0,7929,7929,1
5182,C,7937,0,7933,0,0,1,7933,4
5182,G,7972,2,0,7968,0,0,7968,4
5183,C,7941,0,7940,0,0,1,7940,1
5183,G,7976,3,0,7973,0,0,7973,3
5184,A,7948,7947,1,0,0,0,7947,1
5184,C,7976,0,7971,0,0,2,7971,5
5185,C,7976,1,7975,0,0,0,7975,1
5185,T,7948,0,0,0,0,7948,7948,0
5186,A,7993,7992,0,0,0,0,7992,1
5186,C,7945,0,7942,0,0,1,7942,3
5187,G,7950,1,0,7939,0,9,7939,11
5187,T,7999,0,0,0,0,7966,7966,33
5188,A,7951,7940,0,0,0,9,7940,11
5188,T,8000,0,0,0,0,8000,8000,0
5189,A,7954,7944,9,0,0,0,7944,10
5189,T,8001,0,0,0,0,8001,8001,0
5190,G,7955,1,0,7953,0,0,7953,2
5190,T,8001,0,3,0,0,7997,7997,4
5191,A,7955,7955,0,0,0,0,7955,0
5191,C,8000,0,7986,0,0,1,7986,14
5192,C,8001,0,8000,0,0,1,8000,1
5192,T,7951,2,0,0,0,7948,7948,3
5193,A,8002,8000,1,0,0,0,8000,2
5193,G,7950,0,0,7947,0,0,7947,3
5194,C,8004,0,7999,0,0,0,7999,5
5194,G,7962,0,0,7961,0,1,7961,1
5195,A,7963,7962,0,1,0,0,7962,1
5195,C,8002,1,8000,0,0,1,8000,2
5196,A,8002,8002,0,0,0,0,8002,0
5196,T,7958,0,0,0,0,7956,7956,2
5197,G,7940,0,0,7937,0,0,7937,3
5197,T,8002,0,1,0,0,8001,8001,1
5198,G,8002,0,0,8000,0,1,8000,2
5198,T,7933,0,0,0,0,7931,7931,2
5199,A,8003,8003,0,0,0,0,8003,0
5199,G,7953,1,0,7949,0,1,7949,4
5200,T,7947,0,0,0,0,7945,7945,2
5200,T,8002,0,0,0,0,8002,8002,0
5201,A,8003,8003,0,0,0,0,8003,0
5201,G,7945,0,1,7941,0,0,7941,4
5202,T,7945,0,0,1,0,7929,7929,16
5202,T,8002,2,0,0,0,7995,7995,7
5203,T,7941,1,0,0,0,7940,7940,1
5203,T,7998,0,0,0,0,7998,7998,0
5204,C,8000,0,7998,1,0,1,7998,2
5204,G,7958,0,0,7945,0,3,7945,13
5205,G,7963,0,0,7958,0,3,7958,5
5205,G,7993,1,0,7985,0,0,7985,8
5206,G,7995,1,0,7994,0,0,7994,1
5206,T,7960,0,0,5,0,7797,7797,163
5207,C,7995,0,7995,0,0,0,7995,0
5207,T,7962,0,0,0,0,7962,7962,0
5208,A,7991,7986,0,1,0,0,7986,5
5208,T,7955,1,0,0,0,7954,7954,1
5209,A,7996,7995,0,0,0,0,7995,1
5209,T,7954,0,1,0,0,7952,7952,2
5210,G,7999,1,0,7998,0,0,7998,1
5210,T,7955,0,0,0,0,7955,7955,0
5211,C,7999,0,7999,0,0,0,7999,0
5211,T,7955,0,1,0,0,7949,7949,6
5212,A,8000,7999,1,0,0,0,7999,1
5212,G,7952,0,0,7952,0,0,7952,0
5213,G,8001,1,0,7988,0,2,7988,13
5213,T,7952,0,0,0,0,7950,7950,2
5214,G,7959,0,0,7957,0,0,7957,2
5214,G,8000,0,0,8000,0,0,8000,0
5215,C,7999,0,7996,0,0,3,7996,3
5215,T,7954,0,1,1,0,7948,7948,6
5216,A,7997,7995,0,1,0,0,7995,2
5216,G,7963,1,0,7962,0,0,7962,1
5217,T,7963,0,2,0,0,7960,7960,3
5217,T,8000,0,0,0,0,8000,8000,0
5218,C,7997,0,7994,0,0,1,7994,3
5218,G,7963,1,0,7961,0,0,7961,2
5219,G,8000,0,0,8000,0,0,8000,0
5219,T,7963,0,0,0,0,7962,7962,1
5220,A,7962,7957,0,1,0,0,7957,5
5220,C,8001,1,7994,0,0,0,7994,7
5221,A,7963,7963,0,0,0,0,7963,0
5221,C,8000,0,8000,0,0,0,8000,0
5222,A,7997,7997,0,0,0,0,7997,0
5222,C,7965,0,7964,0,0,0,7964,1
5223,G,7959,0,0,7958,0,1,7958,1
5223,T,7999,0,0,1,0,7997,7997,2
5224,C,7960,0,7959,0,0,0,7959,1
5224,G,8000,2,0,7981,0,0,7981,19
5225,G,8000,1,0,7998,0,1,7998,2
5225,T,7910,0,0,0,0,7910,7910,0
5226,A,7918,7916,1,1,0,0,7916,2
5226,G,7999,1,0,7996,0,2,7996,3
5227,G,7979,2,0,7968,0,0,7968,11
5227,T,7987,0,0,0,0,7987,7987,0
5228,C,7970,0,7969,0,0,1,7969,1
5228,G,7983,0,1,7980,0,0,7980,3
5229,A,7967,7966,0,0,0,0,7966,1
5229,C,7980,0,7976,1,0,1,7976,4
5230,C,7998,0,7993,0,0,5,7993,5
5230,G,7978,1,0,7974,0,0,7974,4
5231,C,7986,0,7982,1,0,2,7982,4
5231,G,8000,0,0,8000,0,0,8000,0
5232,A,8001,8001,0,0,0,0,8001,0
5232,G,7993,1,1,7989,0,2,7989,4
5233,C,7998,0,15990,0,0,0,15990,-7992
5234,C,7998,1,7996,0,0,1,7996,2
5234,G,7992,2,0,7989,0,1,7989,3
5235,A,7985,7984,1,0,0,0,7984,1
5235,T,7999,0,1,0,0,7998,7998,1
5236,G,7992,0,0,7992,0,0,7992,0
5236,G,7999,0,0,7986,0,0,7986,13
5237,A,8000,7998,0,1,0,1,7998,2
5237,G,8000,2,0,7998,0,0,7998,2
5238,T,8000,0,0,0,0,7996,7996,4
5238,T,8001,1,0,0,0,8000,8000,1
5239,C,7999,0,7996,0,0,0,7996,3
5239,G,8001,0,0,8001,0,0,8001,0
5240,C,7994,0,7993,0,0,1,7993,1
5240,T,7997,0,0,0,0,7996,7996,1
5241,A,7996,7995,0,0,0,1,7995,1
5241,T,7993,0,0,0,0,7993,7993,0
5242,C,7993,0,7991,0,0,2,7991,2
5242,C,7997,0,7991,0,0,0,7991,6
5243,C,7985,0,7985,0,0,0,7985,0
5243,G,7997,1,0,7996,0,0,7996,1
5244,C,8000,0,7998,0,0,0,7998,2
5244,G,7990,1,0,7988,0,1,7988,2
5245,A,7969,7967,0,0,0,0,7967,2
5245,C,7995,1,7994,0,0,0,7994,1
5246,G,7978,0,0,7978,0,0,7978,0
5246,G,7995,1,0,7993,0,1,7993,2
5247,A,7976,7973,0,1,0,0,7973,3
5247,T,7996,0,1,0,0,7994,7994,2
5248,A,7974,7973,0,0,0,0,7973,1
5248,C,7995,0,7993,0,0,2,7993,2
5249,C,7977,0,7975,0,0,2,7975,2
5249,G,8000,1,0,7975,0,1,7975,25
5250,G,7983,1,0,7982,0,0,7982,1
5250,G,8001,0,0,8001,0,0,8001,0
5251,A,7986,7984,0,1,0,1,7984,2
5251,G,8002,2,0,8000,0,0,8000,2
5252,C,8002,1,8000,0,0,1,8000,2
5252,T,7996,1,0,0,0,7994,7994,2
5253,A,8000,7999,1,0,0,0,7999,1
5253,C,7995,0,7988,0,0,0,7988,7
5254,C,7995,1,7993,0,0,1,7993,2
5254,T,8001,0,1,1,0,7999,7999,2
5255,G,8001,0,0,8001,0,0,8001,0
5255,T,7995,0,0,0,0,7994,7994,1
5256,C,7997,0,7995,0,0,0,7995,2
5256,C,8002,0,8001,0,0,1,8001,1
5257,G,8002,0,0,8002,0,0,8002,0
5257,T,7991,0,0,0,0,7991,7991,0
5258,C,7999,1,15994,0,0,2,15994,-7995
5259,A,7982,7982,0,0,0,0,7982,0
5259,G,7993,0,0,7992,0,0,7992,1
5260,C,7999,0,7995,0,0,0,7995,4
5260,G,7998,1,0,7996,0,0,7996,2
5261,C,7999,0,7999,0,0,0,7999,0
5261,T,7992,0,0,0,0,7992,7992,0
5262,G,7992,2,0,7990,0,0,7990,2
5262,T,7999,0,0,0,0,7997,7997,2
5263,C,7984,2,7978,1,0,3,7978,6
5263,T,7996,1,0,0,0,7995,7995,1
5264,G,7982,1,1,7979,0,1,7979,3
5264,G,8000,0,0,8000,0,0,8000,0
5265,A,7993,7992,0,0,0,0,7992,1
5265,A,7999,7997,1,1,0,0,7997,2
5266,G,7994,0,0,7994,0,0,7994,0
5266,G,8000,1,0,7999,0,0,7999,1
5267,C,7999,0,7992,0,0,0,7992,7
5267,T,7990,0,1,0,0,7989,7989,1
5268,C,7992,0,7992,0,0,0,7992,0
5268,C,8000,1,7998,0,0,1,7998,2
5269,T,7984,0,1,0,0,7983,7983,1
5269,T,7985,0,0,0,0,7985,7985,0
5270,C,7995,0,7995,0,0,0,7995,0
5270,G,7994,0,0,7994,0,0,7994,0
5271,G,7994,0,0,7994,0,0,7994,0
5271,G,7995,0,0,7995,0,0,7995,0
5272,A,7999,7997,0,1,0,0,7997,2
5272,C,7994,0,7993,0,0,0,7993,1
5273,C,7997,0,7994,0,0,3,7994,3
5273,G,7998,0,0,7997,0,1,7997,1
5274,A,7996,7991,1,1,0,0,7991,5
5274,G,7991,0,0,7990,0,0,7990,1
5275,A,7998,7998,0,0,0,0,7998,0
5275,A,7999,7998,0,1,0,0,7998,1
5276,C,8000,1,7998,1,0,0,7998,2
5276,T,8000,0,0,0,0,8000,8000,0
5277,A,7996,7995,0,0,0,1,7995,1
5277,C,8000,1,7992,0,0,0,7992,8
5278,C,7998,0,7997,0,0,0,7997,1
5278,G,8000,0,0,8000,0,0,8000,0
5279,A,7996,7994,0,0,0,1,7994,2
5279,T,8001,0,0,0,0,7998,7998,3
5280,T,7998,0,0,0,0,7997,7997,1
5280,T,8001,1,0,0,0,8000,8000,1
5281,A,7996,7996,0,0,0,0,7996,0
5281,C,8002,1,8000,0,0,1,8000,2
5282,G,8000,0,1,7998,0,0,7998,2
5282,T,7999,0,0,0,0,7999,7999,0
5283,C,7991,0,7991,0,0,0,7991,0
5283,G,8001,0,0,8001,0,0,8001,0
5284,C,8001,0,7999,0,0,1,7999,2
5284,G,7969,2,0,7967,0,0,7967,2
5285,T,7980,0,0,0,0,7972,7972,8
5285,T,7998,0,1,1,0,7995,7995,3
5286,G,8000,0,0,7994,0,1,7994,6
5286,T,7967,0,0,0,0,7967,7967,0
5287,G,7983,1,0,7982,0,0,7982,1
5287,G,7994,1,0,7992,0,1,7992,2
5288,C,7976,0,7975,0,0,1,7975,1
5288,C,7998,0,7993,1,0,3,7993,5
5289,G,7999,1,0,7998,0,0,7998,1
5289,T,7971,0,0,0,0,7969,7969,2
5290,C,7998,2,7996,0,0,0,7996,2
5290,T,7971,0,0,0,0,7971,7971,0
5291,G,7971,0,0,7966,0,0,7966,5
5291,G,8000,1,0,7999,0,0,7999,1
5292,A,8000,7999,0,0,0,1,7999,1
5292,G,7984,1,0,7983,0,0,7983,1
5293,C,7990,0,7988,1,0,1,7988,2
5293,G,8000,0,0,8000,0,0,8000,0
5294,A,7983,7983,0,0,0,0,7983,0
5294,C,8001,0,7938,0,0,1,7938,63
5295,C,8002,0,8002,0,0,0,8002,0
5295,G,7984,1,0,7983,0,0,7983,1
5296,C,8000,0,8000,0,0,0,8000,0
5296,T,7981,0,0,0,0,7981,7981,0
5297,C,7985,0,7984,0,0,1,7984,1
5297,C,8001,0,8001,0,0,0,8001,0
5298,A,7985,7983,0,1,0,0,7983,2
5298,T,8001,0,1,0,0,8000,8000,1
5299,G,7989,1,0,7986,0,1,7986,3
5299,G,8002,1,0,8001,0,0,8001,1
5300,A,8003,8003,0,0,0,0,8003,0
5300,C,7989,1,7975,0,0,2,7975,14
5301,C,7984,0,7984,0,0,0,7984,0
5301,T,7998,0,0,0,0,7996,7996,2
5302,A,7982,7982,0,0,0,0,7982,0
5302,G,7999,3,0,7996,0,0,7996,3
5303,C,7988,0,7986,0,0,0,7986,2
5303,G,7993,0,0,7993,0,0,7993,0
5304,T,7988,1,1,0,0,7986,7986,2
5304,T,7993,0,0,0,0,7993,7993,0
5305,C,7989,0,7989,0,0,0,7989,0
5305,C,7993,0,7993,0,0,0,7993,0
5306,G,7993,0,1,7990,0,0,7990,3
5306,T,7981,0,1,0,0,7980,7980,1
5307,G,7998,3,0,7995,0,0,7995,3
5307,T,7991,0,0,0,0,7991,7991,0
5308,A,7993,7983,1,1,0,0,7983,10
5308,C,7995,0,7995,0,0,0,7995,0
5309,A,7998,7997,1,0,0,0,7997,1
5309,G,7998,2,0,7996,0,0,7996,2
5310,T,7998,0,1,0,0,7997,7997,1
5310,T,7999,0,0,0,0,7999,7999,0
5311,C,7999,1,15987,0,0,2,15987,-7988
5312,C,7995,0,7995,0,0,0,7995,0
5312,C,7998,0,7998,0,0,0,7998,0
5313,A,7989,7988,1,0,0,0,7988,1
5313,A,7996,7995,0,0,0,0,7995,1
5314,G,7999,1,0,7997,0,1,7997,2
5314,G,8000,0,0,8000,0,0,8000,0
5315,A,8001,8000,0,0,0,0,8000,1
5315,C,7999,0,7999,0,0,0,7999,0
5316,T,7995,0,0,0,0,7988,7988,7
5316,T,7998,0,2,0,0,7994,7994,4
5317,C,7997,0,7995,0,0,1,7995,2
5317,T,7995,0,0,0,0,7995,7995,0
5318,A,7978,7977,0,0,0,0,7977,1
5318,G,7990,0,0,7966,0,0,7966,24
5319,G,7993,1,0,7991,0,1,7991,2
5319,T,7982,0,0,0,0,7981,7981,1
5320,C,7984,0,7982,0,0,0,7982,2
5320,G,7999,1,0,7998,0,0,7998,1
5321,A,7999,7998,1,0,0,0,7998,1
5321,C,7989,1,7988,0,0,0,7988,1
5322,C,8000,0,7989,0,0,0,7989,11
5322,T,7971,0,2,0,0,7969,7969,2
5323,C,7984,0,7983,0,0,1,7983,1
5323,G,7974,0,0,7974,0,0,7974,0
5324,A,7976,7975,0,1,0,0,7975,1
5324,C,7992,0,7992,0,0,0,7992,0
5325,A,7996,7995,0,0,0,0,7995,1
5325,T,7976,0,0,0,0,7976,7976,0
5326,C,7997,0,7996,0,0,1,7996,1
5326,G,7996,1,0,7988,0,1,7988,8
5327,G,7994,1,0,7992,0,0,7992,2
5327,G,7997,0,0,7997,0,0,7997,0
5328,A,7993,7993,0,0,0,0,7993,0
5328,A,7994,7992,0,0,0,0,7992,2
5329,A,7985,7984,0,0,0,1,7984,1
5329,C,7993,0,7992,0,0,0,7992,1
5330,A,7991,7984,0,3,0,0,7984,7
5330,G,7999,0,0,7999,0,0,7999,0
5331,A,7995,7994,0,1,0,0,7994,1
5331,T,7997,0,1,0,0,7996,7996,1
5332,C,7997,1,7985,0,0,0,7985,12
5332,G,7999,0,0,7999,0,0,7999,0
5333,A,7996,7995,0,0,0,0,7995,1
5333,C,7995,0,7995,0,0,0,7995,0
5334,A,7990,7986,0,2,0,0,7986,4
5334,C,7996,0,7991,0,0,1,7991,5
5335,A,7992,7991,0,1,0,0,7991,1
5335,C,7990,2,7987,0,0,1,7987,3
5336,G,7991,0,1,7982,0,0,7982,9
5336,T,7998,0,0,0,0,7998,7998,0
5337,C,7999,0,7998,0,0,1,7998,1
5337,G,8000,1,0,7999,0,0,7999,1
5338,C,8000,0,8000,0,0,0,8000,0
5338,G,8000,1,0,7999,0,0,7999,1
5339,T,7989,0,0,0,0,7989,7989,0
5339,T,8001,0,0,0,0,7999,7999,2
5340,C,7997,0,7996,0,0,1,7996,1
5340,T,8000,0,1,0,0,7999,7999,1
5341,A,7997,7996,0,1,0,0,7996,1
5341,C,7999,0,7995,0,0,0,7995,4
5342,C,7999,0,7999,0,0,0,7999,0
5342,G,7998,2,0,7996,0,0,7996,2
5343,A,7999,7998,0,1,0,0,7998,1
5343,A,8000,7997,0,2,0,0,7997,3
5344,T,7997,0,0,0,0,7997,7997,0
5344,T,8001,0,0,0,0,8000,8000,1
5345,A,7988,7988,0,0,0,0,7988,0
5345,C,8002,0,7998,0,0,1,7998,4
5346,C,7988,0,7987,0,0,1,7987,1
5346,T,7987,0,0,0,0,7982,7982,5
5347,G,8000,2,0,7998,0,0,7998,2
5347,T,7972,0,0,1,0,7971,7971,1
5348,A,8001,7999,0,0,0,0,7999,2
5348,G,7999,1,0,7995,0,1,7995,4
5349,G,8002,0,0,8001,0,0,8001,1
5349,T,7999,0,0,0,0,7999,7999,0
5350,A,7999,7999,0,0,0,0,7999,0
5350,T,8001,0,0,0,0,8001,8001,0
5351,A,8001,7999,0,1,0,1,7999,2
5351,C,8000,0,7998,0,0,1,7998,2
5352,C,8000,0,7999,0,0,1,7999,1
5352,T,7971,0,0,0,0,7971,7971,0
5353,C,7970,0,7970,0,0,0,7970,0
5353,G,8000,0,0,7999,0,0,7999,1
5354,A,7957,7951,0,1,0,0,7951,6
5354,T,7999,0,0,0,0,7998,7998,1
5355,A,7997,7996,1,0,0,0,7996,1
5355,G,8001,0,0,8001,0,0,8001,0
5356,C,8000,0,8000,0,0,0,8000,0
5356,G,7999,0,0,7999,0,0,7999,0
5357,C,7991,0,7973,0,0,1,7973,18
5357,T,8000,0,0,0,0,8000,8000,0
5358,C,7988,1,7986,0,0,1,7986,2
5358,C,7996,0,7996,0,0,0,7996,0
5359,G,7995,0,0,7995,0,0,7995,0
5359,T,7974,0,1,0,0,7973,7973,1
5360,C,7999,0,7999,0,0,0,7999,0
5360,G,7997,1,0,7990,0,0,7990,7
5361,G,7999,0,0,7999,0,0,7999,0
5361,T,8000,0,1,0,0,7999,7999,1
5362,C,7994,0,7993,0,0,1,7993,1
5362,T,7999,0,0,0,0,7999,7999,0
5363,C,8000,0,7999,0,0,0,7999,1
5363,G,7988,0,0,7988,0,0,7988,0
5364,A,7987,7986,0,1,0,0,7986,1
5364,A,8000,8000,0,0,0,0,8000,0
5365,C,7993,0,7993,0,0,0,7993,0
5365,T,8000,0,0,0,0,8000,8000,0
5366,G,7990,1,0,7985,0,1,7985,5
5366,G,8001,4,0,7997,0,0,7997,4
5367,C,8000,0,7999,0,0,1,7999,1
5367,G,7999,0,0,7999,0,0,7999,0
5368,C,7999,0,7999,0,0,0,7999,0
5368,G,8001,0,0,8001,0,0,8001,0
5369,A,7983,7981,0,2,0,0,7981,2
5369,A,8000,8000,0,0,0,0,8000,0
5370,G,7996,0,0,7995,0,0,7995,1
5370,T,7998,0,0,0,0,7998,7998,0
5371,C,7993,1,7991,0,0,0,7991,2
5371,G,8000,0,0,7999,0,0,7999,1
5372,G,7998,0,0,7998,0,0,7998,0
5372,T,7997,0,0,0,0,7979,7979,18
5373,T,7996,0,1,0,0,7995,7995,1
5373,T,7998,0,1,0,0,7997,7997,1
5374,A,7997,7996,0,0,0,0,7996,1
5374,T,7999,0,0,0,0,7999,7999,0
5375,C,7997,0,15990,0,0,1,15990,-7993
5376,C,7981,0,7979,1,0,1,7979,2
5376,G,7997,2,0,7994,0,0,7994,3
5377,C,7999,0,7999,0,0,0,7999,0
5377,G,7989,0,1,7987,0,0,7987,2
5378,A,7989,7988,0,1,0,0,7988,1
5378,T,7989,0,0,0,0,7978,7978,11
5379,T,7980,0,0,0,0,7979,7979,1
5379,T,7993,0,7,0,0,7986,7986,7
5380,C,7979,0,7977,1,0,1,7977,2
5380,G,7990,0,0,7988,0,0,7988,2
5381,G,8000,0,0,8000,0,0,8000,0
5381,T,7957,0,0,0,0,7957,7957,0
5382,G,7999,0,0,7999,0,0,7999,0
5382,T,7998,0,0,1,0,7995,7995,3
5383,G,8000,0,0,7991,0,1,7991,9
5383,T,7998,0,0,0,0,7973,7973,25
5384,G,8001,0,0,8000,0,0,8000,1
5384,T,7996,0,0,0,0,7996,7996,0
5385,T,7995,3,0,0,0,7991,7991,4
5385,T,8000,0,0,1,0,7999,7999,1
5386,A,7981,7963,0,1,0,1,7963,18
5386,C,7997,0,7995,0,0,2,7995,2
5387,A,7994,7992,1,1,0,0,7992,2
5387,G,7999,1,0,7997,0,0,7997,2
5388,A,7993,7991,1,0,0,0,7991,2
5388,A,7998,7997,0,0,0,1,7997,1
5389,A,7995,7993,0,1,0,0,7993,2
5389,C,7996,0,7985,0,0,0,7985,11
5390,C,7995,1,7994,0,0,0,7994,1
5390,T,7985,0,1,0,0,7982,7982,3
5391,G,7988,1,0,7978,0,0,7978,10
5391,T,7937,1,0,0,0,7936,7936,1
5392,A,7936,7934,0,1,0,1,7934,2
5392,G,7994,0,0,7994,0,0,7994,0
5393,G,7979,1,0,7978,0,0,7978,1
5393,G,7996,0,0,7996,0,0,7996,0
5394,A,7981,7981,0,0,0,0,7981,0
5394,C,7999,0,7998,0,0,1,7998,1
5395,A,7998,7996,1,1,0,0,7996,2
5395,T,7991,0,0,0,0,7991,7991,0
5396,A,7988,7988,0,0,0,0,7988,0
5396,G,8000,0,0,7996,0,0,7996,4
5397,G,8000,0,0,8000,0,0,8000,0
5397,T,7999,0,0,0,0,7990,7990,9
5398,T,7988,0,1,0,0,7987,7987,1
5398,T,8000,0,0,0,0,8000,8000,0
5399,A,8000,7999,0,1,0,0,7999,1
5399,G,7991,0,0,7991,0,0,7991,0
5400,A,7990,7989,0,1,0,0,7989,1
5400,G,7999,1,0,7996,0,1,7996,3
5401,C,7999,0,7993,0,0,3,7993,6
5401,T,7994,0,0,0,0,7994,7994,0
5402,A,7965,7964,0,0,0,1,7964,1
5402,C,7992,1,7990,0,0,1,7990,2
5403,G,7969,0,0,7968,0,0,7968,1
5403,G,7993,0,0,7987,0,0,7987,6
5404,G,8000,1,0,7999,0,0,7999,1
5404,T,7970,0,0,0,0,7970,7970,0
5405,A,7999,7999,0,0,0,0,7999,0
5405,C,7972,0,7970,0,0,0,7970,2
5406,T,7949,1,0,0,0,7947,7947,2
5406,T,7995,0,0,0,0,7995,7995,0
5407,C,7992,1,7991,0,0,0,7991,1
5407,G,7950,2,0,7948,0,0,7948,2
5408,A,7950,7950,0,0,0,0,7950,0
5408,A,7991,7987,0,1,0,0,7987,4
5409,A,8000,7998,0,2,0,0,7998,2
5409,T,7948,0,0,0,0,7948,7948,0
5410,C,7946,0,7946,0,0,0,7946,0
5410,G,8001,0,0,8001,0,0,8001,0
5411,C,8002,0,7998,0,0,3,7998,4
5411,G,7939,1,0,7935,0,0,7935,4
5412,G,7964,0,0,7964,0,0,7964,0
5412,G,8003,0,0,8003,0,0,8003,0
5413,T,7961,0,0,0,0,7961,7961,0
5413,T,7977,0,0,0,0,7977,7977,0
5414,A,7977,7977,0,0,0,0,7977,0
5414,C,7960,0,7958,0,0,1,7958,2
5415,A,7959,7956,1,1,0,0,7956,3
5415,T,7978,0,3,0,0,7975,7975,3
5416,A,7998,7997,1,0,0,0,7997,1
5416,G,7977,0,0,7977,0,0,7977,0
5417,C,7979,0,7976,0,0,2,7976,3
5417,C,7999,0,7996,1,0,1,7996,3
5418,A,7951,7947,0,3,0,1,7947,4
5418,G,7999,2,1,7995,0,0,7995,4
5419,G,7955,1,0,7954,0,0,7954,1
5419,T,8000,0,0,0,0,7999,7999,1
5420,A,7999,7998,0,0,0,0,7998,1
5420,C,7958,0,7955,0,0,0,7955,3
5421,C,7948,0,7946,1,0,1,7946,2
5421,T,7989,1,0,0,0,7988,7988,1
5422,A,7979,7971,0,2,0,2,7971,8
5422,G,7951,0,1,7950,0,0,7950,1
5423,A,7985,7984,0,1,0,0,7984,1
5423,C,7956,0,7951,0,0,1,7951,5
5424,C,7957,0,7955,0,0,1,7955,2
5424,T,7985,0,0,0,0,7985,7985,0
5425,C,7908,0,7908,0,0,0,7908,0
5425,G,7999,1,0,7997,0,0,7997,2
5426,C,8000,0,7998,0,0,2,7998,2
5426,G,7908,0,0,7907,0,0,7907,1
5427,A,7872,7872,0,0,0,0,7872,0
5427,A,8000,7999,0,0,0,1,7999,1
5428,G,7899,1,0,7897,0,1,7897,2
5428,T,8001,0,1,0,0,7997,7997,4
5429,T,7898,0,0,0,0,7898,7898,0
5429,T,7996,0,0,0,0,7996,7996,0
5430,C,7898,0,7888,0,0,0,7888,10
5430,G,8000,0,0,8000,0,0,8000,0
5431,C,7897,0,7897,0,0,0,7897,0
5431,C,7999,0,7998,0,0,1,7998,1
5432,A,7994,7994,0,0,0,0,7994,0
5432,T,7895,0,0,0,0,7895,7895,0
5433,A,7898,7898,0,0,0,0,7898,0
5433,T,7995,0,1,0,0,7994,7994,1
5434,C,7978,0,7978,0,0,0,7978,0
5434,G,7899,0,0,7899,0,0,7899,0
5435,A,7996,7992,0,3,0,1,7992,4
5435,C,7902,0,7901,1,0,0,7901,1
5436,G,8000,1,0,7999,0,0,7999,1
5436,T,7896,0,1,0,0,7867,7867,29
5437,C,8001,0,7999,0,0,0,7999,2
5437,T,7880,0,0,0,0,7880,7880,0
5438,C,7999,0,7999,0,0,0,7999,0
5438,T,7886,0,1,0,0,7885,7885,1
5439,A,7986,7985,0,0,0,0,7985,1
5439,T,7892,0,0,1,0,7891,7891,1
5440,G,7895,1,0,7894,0,0,7894,1
5440,T,7986,0,0,0,0,7986,7986,0
5441,C,7895,1,7893,0,0,1,7893,2
5441,G,8000,0,0,8000,0,0,8000,0
5442,A,7895,7886,1,0,0,0,7886,9
5442,A,8001,8001,0,0,0,0,8001,0
5443,A,7896,7896,0,0,0,0,7896,0
5443,T,7998,0,0,0,0,7997,7997,1
5444,A,7894,7894,0,0,0,0,7894,0
5444,G,7984,0,0,7982,0,1,7982,2
5445,C,7940,0,7939,0,0,0,7939,1
5445,G,7968,0,0,7968,0,0,7968,0
5446,A,7939,7939,0,0,0,0,7939,0
5446,A,7970,7967,0,1,0,0,7967,3
5447,T,7962,0,1,0,0,7961,7961,1
5447,T,7971,0,1,0,0,7970,7970,1
5448,A,7965,7965,0,0,0,0,7965,0
5448,C,7961,0,7960,0,0,0,7960,1
5449,C,7978,0,7977,0,0,1,7977,1
5449,T,7966,0,1,1,0,7964,7964,2
5450,A,7996,7996,0,0,0,0,7996,0
5450,T,7971,0,0,1,0,7953,7953,18
5451,T,7973,0,0,1,0,7972,7972,1
5451,T,7999,0,0,0,0,7999,7999,0
5452,C,7999,0,7999,0,0,0,7999,0
5452,T,7974,0,1,0,0,7973,7973,1
5453,A,8000,7995,0,0,0,0,7995,5
5453,C,7972,0,7969,0,0,2,7969,3
5454,A,7975,7973,0,1,0,0,7973,2
5454,T,7969,0,1,0,0,7966,7966,3
5455,C,7973,0,7973,0,0,0,7973,0
5455,G,7981,0,0,7981,0,0,7981,0
5456,A,7969,7969,0,0,0,0,7969,0
5456,G,7977,2,0,7964,0,1,7964,13
5457,G,7973,0,0,7973,0,0,7973,0
5457,G,7985,2,0,7983,0,0,7983,2
5458,A,7972,7972,0,0,0,0,7972,0
5458,C,7983,0,7982,0,0,1,7982,1
5459,A,7972,7971,1,0,0,0,7971,1
5459,C,7990,0,7990,0,0,0,7990,0
5460,A,7985,7982,0,2,0,0,7982,3
5460,G,7977,0,0,7975,0,0,7975,2
5461,G,7998,0,0,7997,0,0,7997,1
5461,G,7999,0,0,7998,0,0,7998,1
5462,A,7999,7998,0,1,0,0,7998,1
5462,G,7999,3,0,7996,0,0,7996,3
5463,A,7999,7997,0,0,0,0,7997,2
5463,G,8000,3,0,7996,0,1,7996,4
5464,C,7998,0,7997,0,0,1,7997,1
5464,T,7997,0,0,1,0,7996,7996,1
5465,A,7999,7996,0,0,0,0,7996,3
5465,C,7996,0,7995,0,0,1,7995,1
5466,A,7992,7992,0,0,0,0,7992,0
5466,A,7998,7997,0,0,0,0,7997,1
5467,G,7999,1,0,15994,0,0,15994,-7995
5468,C,7998,0,7997,0,0,0,7997,1
5468,G,8000,0,0,8000,0,0,8000,0
5469,A,7982,7982,0,0,0,0,7982,0
5469,T,7997,0,0,0,0,7997,7997,0
5470,G,7982,0,0,7973,0,0,7973,9
5470,G,7985,0,0,7985,0,0,7985,0
5471,A,7983,7982,0,0,0,0,7982,1
5471,G,7967,0,0,7966,0,1,7966,1
5472,A,7962,7962,0,0,0,0,7962,0
5472,G,8000,0,0,8000,0,0,8000,0
5473,A,8000,8000,0,0,0,0,8000,0
5473,G,7965,0,0,7951,0,0,7951,14
5474,G,7965,0,0,7964,0,1,7964,1
5474,T,8000,0,0,0,0,7999,7999,1
5475,C,7966,0,7964,1,0,1,7964,2
5475,G,7995,0,0,7995,0,0,7995,0
5476,A,7995,7994,0,1,0,0,7994,1
5476,T,7962,0,0,1,0,7945,7945,17
5477,C,8000,0,7999,0,0,0,7999,1
5477,T,7961,0,0,1,0,7960,7960,1
5478,A,7994,7992,0,2,0,0,7992,2
5478,T,7974,0,0,0,0,7974,7974,0
5479,C,7977,0,7975,0,0,1,7975,2
5479,G,7995,0,0,7992,0,0,7992,3
5480,G,7977,3,0,7974,0,0,7974,3
5480,G,7998,0,0,7998,0,0,7998,0
5481,A,7991,7990,0,0,0,0,7990,1
5481,C,7984,0,7983,0,0,0,7983,1
5482,A,7985,7983,0,0,0,0,7983,2
5482,G,7993,0,0,7993,0,0,7993,0
5483,A,7997,7997,0,0,0,0,7997,0
5483,T,7983,0,0,0,0,7983,7983,0
5484,G,7985,1,0,7984,0,0,7984,1
5484,T,7998,0,0,0,0,7997,7997,1
5485,A,7984,7981,0,2,0,0,7981,3
5485,C,7994,0,7989,0,0,0,7989,5
5486,C,7986,1,7985,0,0,0,7985,1
5486,G,7998,0,0,7997,0,1,7997,1
5487,T,7985,0,0,0,0,7985,7985,0
5487,T,7989,0,1,0,0,7988,7988,1
5488,A,7992,7991,0,1,0,0,7991,1
5488,G,7997,0,1,7996,0,0,7996,1
5489,C,7998,0,7907,0,0,0,7907,91
5489,T,7991,0,0,1,0,7989,7989,2
5490,C,7996,0,7995,0,0,1,7995,1
5490,T,7986,0,1,0,0,7985,7985,1
5491,C,7994,0,7994,0,0,0,7994,0
5491,C,7999,0,7998,0,0,1,7998,1
5492,A,7996,7986,0,1,0,0,7986,10
5492,C,7987,0,7983,2,0,1,7983,4
5493,A,7998,7998,0,0,0,0,7998,0
5493,G,7985,1,2,7977,0,0,7977,8
5494,C,7998,0,7996,0,0,1,7996,2
5494,G,7990,0,0,7990,0,0,7990,0
5495,A,7939,7936,0,0,0,1,7936,3
5495,C,7991,0,7990,0,0,1,7990,1
5496,A,7990,7990,0,0,0,0,7990,0
5496,T,7944,0,0,1,0,7934,7934,10
5497,C,7991,0,7991,0,0,0,7991,0
5497,T,7939,0,0,1,0,7938,7938,1
5498,T,7940,0,0,0,0,7940,7940,0
5498,T,7978,0,1,0,0,7976,7976,2
5499,C,7940,1,7931,0,0,1,7931,9
5499,T,7986,1,1,0,0,7984,7984,2
5500,C,7935,0,7932,0,0,3,7932,3
5500,C,7985,0,7985,0,0,0,7985,0
5501,G,7938,3,0,7934,0,0,7934,4
5501,G,7999,0,0,7999,0,0,7999,0
5502,C,8000,1,7983,0,0,0,7983,17
5502,T,7928,0,1,0,0,7927,7927,1
5503,C,8000,0,8000,0,0,0,8000,0
5503,G,7928,2,0,7926,0,0,7926,2
5504,C,8001,1,7999,0,0,1,7999,2
5504,T,7928,0,0,0,0,7928,7928,0
5505,A,8000,7998,0,1,0,0,7998,2
5505,C,7922,1,7920,0,0,1,7920,2
5506,A,7999,7997,0,0,0,1,7997,2
5506,G,7926,1,0,7925,0,0,7925,1
5507,C,7960,0,7937,0,0,0,7937,23
5507,T,7998,0,0,0,0,7998,7998,0
5508,A,7995,7992,0,2,0,0,7992,3
5508,C,7961,0,7961,0,0,0,7961,0
5509,C,7970,0,7970,0,0,0,7970,0
5509,G,7995,0,1,7994,0,0,7994,1
5510,C,7982,0,7979,0,0,3,7979,3
5510,T,7968,2,1,0,0,7965,7965,3
5511,A,7993,7992,0,0,0,0,7992,1
5511,T,7970,1,0,0,0,7969,7969,1
5512,A,7975,7974,0,0,0,0,7974,1
5512,G,8000,1,0,7999,0,0,7999,1
5513,C,7992,0,7988,0,0,0,7988,4
5513,T,7975,1,0,0,0,7967,7967,8
5514,C,7993,1,7991,0,0,1,7991,2
5514,T,7974,0,0,0,0,7973,7973,1
5515,A,7979,7978,0,0,0,0,7978,1
5515,C,7974,0,7907,0,0,1,7907,67
5516,C,7950,0,7950,0,0,0,7950,0
5516,G,8000,0,0,7998,0,0,7998,2
5517,C,7951,0,7947,0,0,3,7947,4
5517,T,8001,0,1,0,0,8000,8000,1
5518,C,8002,0,7953,0,0,0,7953,49
5518,T,7946,0,5,0,0,7817,7817,129
5519,C,8002,0,8002,0,0,0,8002,0
5519,T,7946,0,0,0,0,7946,7946,0
5520,C,7996,0,7995,0,0,1,7995,1
5520,T,7947,1,0,0,0,7946,7946,1
5521,T,7947,0,0,0,0,7947,7947,0
5521,T,7990,0,0,0,0,7989,7989,1
5522,T,7949,0,0,0,0,7949,7949,0
5522,T,7998,0,1,0,0,7996,7996,2
5523,C,7997,0,7964,0,0,1,7964,33
5523,T,7948,0,0,0,0,7948,7948,0
5524,C,8000,0,7999,0,0,1,7999,1
5524,G,7948,0,0,7947,0,1,7947,1
5525,C,7948,0,7947,1,0,0,7947,1
5525,C,7993,1,7992,0,0,0,7992,1
5526,G,7946,1,0,7940,0,0,7940,6
5526,G,7997,3,0,7994,0,0,7994,3
5527,C,7998,0,7996,0,0,0,7996,2
5527,G,7958,0,0,7958,0,0,7958,0
5528,C,7959,0,7958,0,0,1,7958,1
5528,T,7998,2,1,0,0,7992,7992,6
5529,A,7963,7962,0,0,0,0,7962,1
5529,T,7989,0,0,0,0,7989,7989,0
5530,C,7992,0,7991,0,0,1,7991,1
5530,T,7963,0,0,1,0,7921,7921,42
5531,A,7991,7990,0,1,0,0,7990,1
5531,T,7964,0,0,0,0,7964,7964,0
5532,G,7999,0,0,7999,0,0,7999,0
5532,T,7966,0,1,1,0,7964,7964,2
5533,T,7965,0,1,0,0,7964,7964,1
5533,T,7998,0,0,0,0,7998,7998,0
5534,G,7967,1,0,7965,0,0,7965,2
5534,G,8000,1,0,7999,0,0,7999,1
5535,A,7999,7999,0,0,0,0,7999,0
5535,C,7967,0,7960,0,0,0,7960,7
5536,C,7965,1,7963,0,0,1,7963,2
5536,C,7995,0,7994,0,0,1,7994,1
5537,A,7991,7988,0,0,0,0,7988,3
5537,T,7960,0,0,1,0,7954,7954,6
5538,A,7999,7997,0,0,0,1,7997,2
5538,T,7956,0,1,0,0,7955,7955,1
5539,C,7956,1,7945,0,0,1,7945,11
5539,C,7996,1,7994,0,0,1,7994,2
5540,C,7956,0,7956,0,0,0,7956,0
5540,G,8000,0,0,8000,0,0,8000,0
5541,T,7956,0,3,0,0,7952,7952,4
5541,T,7999,0,0,1,0,7998,7998,1
5542,C,7995,1,7994,0,0,0,7994,1
5542,G,7971,0,0,7970,0,1,7970,1
5543,G,8000,1,0,7999,0,0,7999,1
5543,T,7970,0,0,0,0,7880,7880,90
5544,A,7998,7998,0,0,0,0,7998,0
5544,T,7969,1,0,0,0,7968,7968,1
5545,G,8000,2,0,7998,0,0,7998,2
5545,T,7970,0,0,0,0,7970,7970,0
5546,C,8000,0,7999,0,0,1,7999,1
5546,T,7969,1,1,0,0,7967,7967,2
5547,A,7996,7994,1,0,0,1,7994,2
5547,T,7970,1,0,1,0,7968,7968,2
5548,C,8000,3,7996,0,0,1,7996,4
5548,G,7970,0,0,7968,0,2,7968,2
5549,A,7983,7980,1,1,0,1,7980,3
5549,C,7970,0,7970,0,0,0,7970,0
5550,G,7996,0,0,7996,0,0,7996,0
5550,T,7967,0,0,0,0,7967,7967,0
5551,C,7963,0,7962,0,0,1,7962,1
5551,C,7998,0,7998,0,0,0,7998,0
5552,A,7967,7966,0,0,0,0,7966,1
5552,T,7987,1,1,0,0,7985,7985,2
5553,C,7995,1,7967,0,0,0,7967,28
5553,G,8000,1,0,7998,0,0,7998,2
5554,C,7995,0,7993,2,0,0,7993,2
5554,C,7996,0,7992,2,0,2,7992,4
5555,C,7999,1,7996,0,0,2,7996,3
5555,G,7997,2,1,7994,0,0,7994,3
5556,A,7999,7999,0,0,0,0,7999,0
5556,C,7999,0,7999,0,0,0,7999,0
5557,A,7987,7985,0,1,0,0,7985,2
5557,G,8000,0,0,8000,0,0,8000,0
5558,A,7998,7997,0,1,0,0,7997,1
5558,A,8000,7973,1,0,0,0,7973,27
5559,A,8000,7999,0,0,0,1,7999,1
5559,G,7995,0,0,7988,0,1,7988,7
5560,A,7998,7997,1,0,0,0,7997,1
5560,G,8000,0,0,7999,0,0,7999,1
5561,A,7998,7989,0,0,0,0,7989,9
5561,C,7995,0,7995,0,0,0,7995,0
5562,A,7988,7987,0,1,0,0,7987,1
5562,G,7982,1,0,7980,0,0,7980,2
5563,C,7981,0,7978,2,0,0,7978,3
5563,C,7992,0,7989,0,0,2,7989,3
5564,G,7990,1,1,7987,0,0,7987,3
5564,T,7972,0,3,1,0,7968,7968,4
5565,C,7995,0,7967,1,0,1,7967,28
5565,G,7984,0,0,7978,0,0,7978,6
5566,C,7995,0,7994,0,0,1,7994,1
5566,G,7985,0,0,7985,0,0,7985,0
5567,C,7994,0,7992,0,0,1,7992,2
5567,T,7984,0,0,0,0,7984,7984,0
5568,G,7985,1,0,7983,0,0,7983,2
5568,G,7998,0,0,7997,0,1,7997,1
5569,A,7982,7975,2,1,0,0,7975,7
5569,T,7998,0,0,0,0,7997,7997,1
5570,A,7996,7994,1,1,0,0,7994,2
5570,C,7998,0,7997,0,0,0,7997,1
5571,A,7999,7998,0,0,0,0,7998,1
5571,G,7999,1,1,7995,0,0,7995,4
5572,G,7999,2,0,7997,0,0,7997,2
5572,T,7993,0,0,0,0,7993,7993,0
5573,G,7998,1,0,7992,0,0,7992,6
5573,T,8000,1,0,0,0,7999,7999,1
5574,A,7997,7966,0,0,0,0,7966,31
5574,G,7999,3,0,7996,0,0,7996,3
5575,A,7997,7996,1,0,0,0,7996,1
5575,C,8000,0,7993,0,0,0,7993,7
5576,A,7997,7995,0,2,0,0,7995,2
5576,C,8000,0,7999,0,0,1,7999,1
5577,A,7995,7995,0,0,0,0,7995,0
5577,A,7997,7995,0,2,0,0,7995,2
5578,G,7997,0,0,7997,0,0,7997,0
5578,G,8000,0,0,8000,0,0,8000,0
5579,A,7989,7989,0,0,0,0,7989,0
5579,C,8001,0,7996,0,0,2,7996,5
5580,C,8002,0,8002,0,0,0,8002,0
5580,T,7990,0,0,0,0,7990,7990,0
5581,A,8002,8002,0,0,0,0,8002,0
5581,G,7985,2,0,7983,0,0,7983,2
5582,C,7993,0,7990,0,0,2,7990,3
5582,C,8003,0,8000,0,0,2,8000,3
5583,G,8003,2,0,8001,0,0,8001,2
5583,T,7990,0,0,0,0,7990,7990,0
5584,A,8003,8002,0,0,0,0,8002,1
5584,G,7999,0,0,7998,0,0,7998,1
5585,A,7998,7992,1,2,0,0,7992,6
5585,T,8004,0,0,0,0,8004,8004,0
5586,A,7995,7992,1,1,0,0,7992,3
5586,A,7999,7998,1,0,0,0,7998,1
5587,G,7992,1,0,7991,0,0,7991,1
5587,G,8000,1,0,7998,0,0,7998,2
5588,A,7999,7999,0,0,0,0,7999,0
5588,C,7991,0,7984,1,0,1,7984,7
5589,C,7982,0,7982,0,0,0,7982,0
5589,T,7999,0,1,0,0,7998,7998,1
5590,C,7998,0,7995,0,0,1,7995,3
5590,G,7993,0,0,7993,0,0,7993,0
5591,A,7990,7989,0,0,0,1,7989,1
5591,C,7985,1,7984,0,0,0,7984,1
5592,G,7985,1,0,7983,0,0,7983,2
5592,G,7993,1,0,7989,0,1,7989,4
5593,C,7987,0,7984,0,0,2,7984,3
5593,T,7987,0,1,1,0,7977,7977,10
5594,T,7984,0,1,0,0,7983,7983,1
5594,T,7986,0,0,1,0,7985,7985,1
5595,G,7982,0,0,7964,0,1,7964,18
5595,G,8000,1,0,7999,0,0,7999,1
5596,C,7997,0,7989,0,0,1,7989,8
5596,G,7964,1,0,7963,0,0,7963,1
5597,C,7998,1,7996,0,0,0,7996,2
5597,G,7969,0,0,7968,0,1,7968,1
5598,T,7959,0,0,1,0,7958,7958,1
5598,T,7999,1,0,0,0,7998,7998,1
5599,C,7995,0,7995,0,0,0,7995,0
5599,G,7963,0,0,7961,0,0,7961,2
5600,C,7963,1,7961,0,0,1,7961,2
5600,G,8000,1,0,7998,0,0,7998,2
5601,G,7963,2,0,7960,0,1,7960,3
5601,T,8001,0,0,0,0,8001,8001,0
5602,C,7969,0,7969,0,0,0,7969,0
5602,C,8000,0,7987,0,0,1,7987,13
5603,C,8001,0,8001,0,0,0,8001,0
5603,G,7970,0,0,7968,0,0,7968,2
5604,A,7971,7971,0,0,0,0,7971,0
5604,T,7997,0,1,0,0,7995,7995,2
5605,G,7972,2,0,7970,0,0,7970,2
5605,G,7999,2,0,7997,0,0,7997,2
5606,C,8000,0,7998,0,0,2,7998,2
5606,T,7958,0,0,1,0,7956,7956,2
5607,A,7998,7997,0,1,0,0,7997,1
5607,G,7991,1,0,7968,0,1,7968,23
5608,G,7999,0,0,7997,0,1,7997,2
5608,G,8000,1,0,7998,0,0,7998,2
5609,G,7999,1,0,7997,0,0,7997,2
5609,T,7975,0,0,0,0,7970,7970,5
5610,T,7977,0,1,0,0,7976,7976,1
5610,T,7998,0,1,0,0,7992,7992,6
5611,C,7976,0,7976,0,0,0,7976,0
5611,T,7994,0,0,0,0,7994,7994,0
5612,A,7995,7993,0,1,0,0,7993,2
5612,A,7999,7999,0,0,0,0,7999,0
5613,C,8000,0,8000,0,0,0,8000,0
5613,T,7996,1,0,0,0,7991,7991,5
5614,A,8001,7998,0,1,0,0,7998,3
5614,T,7994,0,0,0,0,7994,7994,0
5615,C,7995,0,7994,0,0,1,7994,1
5615,T,8001,0,0,0,0,8001,8001,0
5616,A,7988,7985,1,1,0,0,7985,3
5616,C,7982,0,7982,0,0,0,7982,0
5617,G,7992,3,0,7989,0,0,7989,3
5617,G,7996,1,0,7974,0,1,7974,22
5618,A,7998,7993,0,1,0,0,7993,5
5618,G,7998,0,0,7998,0,0,7998,0
5619,A,7998,7997,0,0,0,1,7997,1
5619,G,7996,0,0,7996,0,0,7996,0
5620,C,7995,0,7995,0,0,0,7995,0
5620,C,7998,0,7996,0,0,1,7996,2
5621,A,7985,7985,0,0,0,0,7985,0
5621,T,7993,1,1,0,0,7991,7991,2
5622,C,7992,0,7986,0,0,2,7986,6
5622,G,7998,0,0,7994,0,1,7994,4
5623,C,7990,0,7989,0,0,1,7989,1
5623,G,8000,0,0,8000,0,0,8000,0
5624,A,8000,7998,0,0,0,1,7998,2
5624,G,8000,1,0,7978,0,3,7978,22
5625,G,8001,1,0,8000,0,0,8000,1
5625,T,8001,0,0,0,0,8001,8001,0
5626,A,7994,7994,0,0,0,0,7994,0
5626,C,7996,1,7993,1,0,0,7993,3
5627,C,7994,0,7990,0,0,4,7990,4
5627,T,7990,0,0,0,0,7989,7989,1
5628,A,7972,7972,0,0,0,0,7972,0
5628,C,7994,0,7990,1,0,2,7990,4
5629,A,7991,7982,1,0,0,1,7982,9
5629,G,7989,0,0,7984,0,0,7984,5
5630,A,7992,7991,0,0,0,1,7991,1
5630,G,7987,2,0,7985,0,0,7985,2
5631,C,7991,0,7990,0,0,0,7990,1
5631,T,7986,0,0,0,0,7985,7985,1
5632,A,7957,7954,0,2,0,0,7954,3
5632,C,7987,0,7984,0,0,3,7984,3
5633,G,7966,0,0,7966,0,0,7966,0
5633,G,7976,4,0,7969,0,0,7969,7
5634,C,7962,0,7961,0,0,1,7961,1
5634,G,7999,0,0,7999,0,0,7999,0
5635,G,7971,0,0,7962,0,0,7962,9
5635,T,7999,0,0,0,0,7999,7999,0
5636,C,7999,0,7999,0,0,0,7999,0
5636,G,7977,1,0,7975,0,0,7975,2
5637,T,7977,0,0,0,0,7977,7977,0
5637,T,7999,0,0,0,0,7996,7996,3
5638,A,7978,7973,0,0,0,1,7973,5
5638,T,7990,0,0,0,0,7990,7990,0
5639,A,7979,7979,0,0,0,0,7979,0
5639,G,7994,2,0,7992,0,0,7992,2
5640,A,7993,7992,0,0,0,0,7992,1
5640,G,7984,0,0,7984,0,0,7984,0
5641,A,7996,7995,0,0,0,0,7995,1
5641,C,7994,0,7994,0,0,0,7994,0
5642,A,7992,7913,1,0,0,0,7913,79
5642,T,7977,1,0,0,0,7976,7976,1
5643,A,7982,7982,0,0,0,0,7982,0
5643,C,7989,0,7984,0,0,0,7984,5
5644,A,7989,7989,0,0,0,0,7989,0
5644,C,7986,0,7985,0,0,1,7985,1
5645,A,7989,7989,0,0,0,0,7989,0
5645,T,7983,0,0,0,0,7980,7980,3
5646,A,7990,7986,0,4,0,0,7986,4
5646,T,7983,0,1,1,0,7981,7981,2
5647,G,7983,0,0,7982,0,0,7982,1
5647,G,7991,1,0,7990,0,0,7990,1
5648,A,7981,7980,0,0,0,1,7980,1
5648,A,7989,7983,0,0,0,0,7983,6
5649,A,7989,7989,0,0,0,0,7989,0
5649,G,7983,0,0,7983,0,0,7983,0
5650,A,7968,7966,0,1,0,0,7966,2
5650,C,7990,0,7979,0,0,0,7979,11
5651,C,7984,0,7981,2,0,1,7981,3
5651,G,7971,0,0,7967,0,0,7967,4
5652,G,7986,1,0,7950,0,0,7950,36
5652,T,7958,1,0,1,0,7926,7926,32
5653,G,7984,0,0,7983,0,1,7983,1
5653,T,7955,0,0,0,0,7955,7955,0
5654,G,7985,1,0,7983,0,1,7983,2
5654,T,7955,0,0,0,0,7955,7955,0
5655,C,7986,0,7983,1,0,2,7983,3
5655,T,7955,0,2,0,0,7953,7953,2
5656,C,7955,1,7951,0,0,2,7951,4
5656,G,7985,0,0,7983,0,0,7983,2
5657,C,8000,0,7945,1,0,1,7945,55
5657,G,7956,1,0,7955,0,0,7955,1
5658,C,7958,0,7859,0,0,1,7859,99
5658,C,8000,0,7999,0,0,1,7999,1
5659,C,7956,0,7956,0,0,0,7956,0
5659,C,8001,0,8001,0,0,0,8001,0
5660,C,7955,0,7955,0,0,0,7955,0
5660,C,8002,0,8001,0,0,1,8001,1
5661,C,7955,0,7953,2,0,0,7953,2
5661,T,8002,0,0,0,0,8001,8001,1
5662,G,7969,0,1,7968,0,0,7968,1
5662,G,8003,1,0,8000,0,0,8000,3
5663,A,7969,7969,0,0,0,0,7969,0
5663,C,8001,0,8000,0,0,0,8000,1
5664,A,7969,7969,0,0,0,0,7969,0
5664,G,8003,1,0,8001,0,1,8001,2
5665,C,8004,0,8004,0,0,0,8004,0
5665,G,7970,0,0,7970,0,0,7970,0
5666,A,7971,7969,0,0,0,0,7969,2
5666,T,7976,0,1,0,0,7975,7975,1
5667,A,7971,7969,1,1,0,0,7969,2
5667,G,7978,1,0,7976,0,0,7976,2
5668,A,7978,7978,0,0,0,0,7978,0
5668,C,7972,1,7970,0,0,1,7970,2
5669,C,7983,0,7981,0,0,1,7981,2
5669,G,7974,4,0,7970,0,0,7970,4
5670,A,7984,7980,0,2,0,1,7980,4
5670,C,7982,0,7979,0,0,2,7979,3
5671,G,7984,0,0,7982,0,0,7982,2
5671,T,7972,0,1,0,0,7960,7960,12
5672,C,7986,0,7983,1,0,0,7983,3
5672,T,7999,0,0,0,0,7999,7999,0
5673,C,7984,0,7984,0,0,0,7984,0
5673,T,7999,0,1,0,0,7997,7997,2
5674,C,7999,0,7991,0,0,0,7991,8
5674,G,7984,2,0,7978,0,1,7978,6
5675,C,8000,0,7999,0,0,0,7999,1
5675,G,7992,0,0,7992,0,0,7992,0
5676,A,7990,7986,1,0,0,0,7986,4
5676,A,7995,7993,0,1,0,0,7993,2
5677,A,7991,7991,0,0,0,0,7991,0
5677,A,7999,7999,0,0,0,0,7999,0
5678,C,7991,0,7989,0,0,2,7989,2
5678,T,8000,0,0,1,0,7997,7997,3
5679,A,7989,7987,0,0,0,0,7987,2
5679,G,7994,0,0,7994,0,0,7994,0
5680,A,7994,7993,0,0,0,1,7993,1
5680,C,7989,0,7989,0,0,0,7989,0
5681,G,7983,0,0,7980,0,0,7980,3
5681,T,7945,0,0,0,0,7945,7945,0
5682,G,7944,0,0,7944,0,0,7944,0
5682,G,7983,0,0,7982,0,0,7982,1
5683,A,7934,7934,0,0,0,0,7934,0
5683,C,7982,0,7980,0,0,2,7980,2
5684,G,7934,0,0,7933,0,0,7933,1
5684,G,7974,0,0,7972,0,0,7972,2
5685,C,7934,0,7932,0,0,2,7932,2
5685,G,7982,1,0,7980,0,1,7980,2
5686,A,7934,7933,0,0,0,0,7933,1
5686,C,7998,0,7994,0,0,4,7994,4
5687,A,7999,7995,2,2,0,0,7995,4
5687,C,7996,0,7994,1,0,1,7994,2
5688,T,7994,0,0,0,0,7951,7951,43
5688,T,8000,0,1,0,0,7999,7999,1
5689,C,8001,0,8000,0,0,1,8000,1
5689,T,7995,0,0,0,0,7995,7995,0
5690,A,7997,7995,0,0,0,0,7995,2
5690,T,7995,0,0,0,0,7995,7995,0
5691,G,7999,0,0,7999,0,0,7999,0
5691,T,7995,1,1,0,0,7993,7993,2
5692,A,7995,7984,0,0,0,0,7984,11
5692,A,7999,7999,0,0,0,0,7999,0
5693,A,7996,7994,0,2,0,0,7994,2
5693,G,7999,1,0,7998,0,0,7998,1
5694,A,7994,7993,0,1,0,0,7993,1
5694,C,7988,0,7988,0,0,0,7988,0
5695,A,7976,7975,0,0,0,0,7975,1
5695,G,7999,0,0,7999,0,0,7999,0
5696,G,7981,1,0,7980,0,0,7980,1
5696,T,7945,0,0,0,0,7937,7937,8
5697,C,7982,0,7976,0,0,1,7976,6
5697,T,7946,0,0,0,0,7946,7946,0
5698,C,7979,0,7978,0,0,0,7978,1
5698,C,7982,0,7981,0,0,1,7981,1
5699,G,7982,0,0,7982,0,0,7982,0
5699,T,7979,0,0,0,0,7979,7979,0
5700,A,7991,7990,0,0,0,0,7990,1
5700,G,7999,0,0,7997,0,2,7997,2
5701,C,7999,0,7999,0,0,0,7999,0
5701,T,7991,0,0,0,0,7982,7982,9
5702,T,7999,0,0,0,0,15997,15997,-7998
5703,A,8000,8000,0,0,0,0,8000,0
5703,G,8000,0,0,8000,0,0,8000,0
5704,T,7989,0,0,0,0,7988,7988,1
5704,T,7999,0,0,0,0,7999,7999,0
5705,C,7997,0,7994,0,0,2,7994,3
5705,G,7990,1,0,7989,0,0,7989,1
5706,T,7989,0,0,1,0,7987,7987,2
5706,T,7995,1,0,0,0,7994,7994,1
5707,G,7952,0,0,7942,0,1,7942,10
5707,G,7999,0,0,7999,0,0,7999,0
5708,G,7961,1,0,7960,0,0,7960,1
5708,T,8000,0,1,0,0,7994,7994,6
5709,C,7946,0,7944,0,0,1,7944,2
5709,T,7988,0,0,0,0,7988,7988,0
5710,G,7946,0,0,7945,0,0,7945,1
5710,G,7994,0,0,7992,0,0,7992,2
5711,C,7948,0,7947,0,0,0,7947,1
5711,T,7979,0,0,0,0,7978,7978,1
5712,G,7944,0,0,7938,0,0,7938,6
5712,G,7988,3,0,7984,0,0,7984,4
5713,C,7988,0,7957,1,0,0,7957,31
5713,G,7999,3,0,7996,0,0,7996,3
5714,C,7984,1,7981,0,0,1,7981,3
5714,T,7997,0,0,0,0,7996,7996,1
5715,A,7998,7998,0,0,0,0,7998,0
5715,C,7982,1,7980,0,0,1,7980,2
5716,A,7977,7977,0,0,0,0,7977,0
5716,T,7997,2,1,0,0,7990,7990,7
5717,G,7998,0,0,7998,0,0,7998,0
5717,T,7990,1,0,0,0,7989,7989,1
5718,A,7998,7998,0,0,0,0,7998,0
5718,T,7999,0,0,0,0,7999,7999,0
5719,C,7996,0,7996,0,0,0,7996,0
5719,T,7999,1,0,0,0,7998,7998,1
5720,A,7994,7993,1,0,0,0,7993,1
5720,C,7996,0,7958,0,0,1,7958,38
5721,C,7998,0,7997,0,0,1,7997,1
5721,T,7991,0,0,0,0,7991,7991,0
5722,A,7990,7989,0,0,0,0,7989,1
5722,C,7869,3,7865,1,0,0,7865,4
5723,G,7878,1,1,7876,0,0,7876,2
5723,G,7998,3,0,7994,0,0,7994,4
5724,C,7998,0,7993,0,0,0,7993,5
5724,T,7884,0,0,0,0,7884,7884,0
5725,A,7884,7884,0,0,0,0,7884,0
5725,C,7981,0,7981,0,0,0,7981,0
5726,G,7937,1,0,7936,0,0,7936,1
5726,T,7884,1,1,0,0,7877,7877,7
5727,A,7938,7934,1,0,0,0,7934,4
5727,T,7869,0,0,0,0,7869,7869,0
5728,A,7938,7934,0,2,0,2,7934,4
5728,G,7870,0,0,7870,0,0,7870,0
5729,A,7864,7863,0,0,0,0,7863,1
5729,T,7939,0,0,0,0,7939,7939,0
5730,A,7937,7937,0,0,0,0,7937,0
5730,C,7868,0,7867,0,0,0,7867,1
5731,G,7868,1,0,7866,0,0,7866,2
5731,G,7939,0,0,7939,0,0,7939,0
5732,C,7866,1,7858,0,0,1,7858,8
5732,C,7937,0,7924,0,0,2,7924,13
5733,C,7854,1,7852,0,0,1,7852,2
5733,C,7939,0,7938,0,0,0,7938,1
5734,G,7860,0,0,7835,0,0,7835,25
5734,T,7939,0,1,0,0,7938,7938,1
5735,C,7947,0,7945,0,0,2,7945,2
5735,G,7873,0,0,7873,0,0,7873,0
5736,G,7873,1,0,7872,0,0,7872,1
5736,T,7945,0,1,0,0,7944,7944,1
5737,C,7873,0,7869,0,0,3,7869,4
5737,C,7954,0,7950,0,0,0,7950,4
5738,A,7870,7864,1,0,0,0,7864,6
5738,C,7953,0,7951,0,0,1,7951,2
5739,A,7870,7870,0,0,0,0,7870,0
5739,A,7960,7959,1,0,0,0,7959,1
5740,C,7963,0,7951,0,0,0,7951,12
5740,G,7880,0,0,7879,0,1,7879,1
5741,A,7880,7879,0,0,0,1,7879,1
5741,C,7954,0,7954,0,0,0,7954,0
5742,C,7946,0,7946,0,0,0,7946,0
5742,G,7879,1,0,7877,0,1,7877,2
5743,A,7944,7940,0,0,0,0,7940,4
5743,C,7869,0,7868,0,0,1,7868,1
5744,A,7858,7854,0,2,0,0,7854,4
5744,A,7943,7942,0,1,0,0,7942,1
5745,A,7857,7857,0,0,0,0,7857,0
5745,G,7943,2,0,7941,0,0,7941,2
5746,C,7861,0,7860,0,0,1,7860,1
5746,C,7942,0,7942,0,0,0,7942,0
5747,G,7941,0,0,7930,0,0,7930,11
5747,T,7861,0,0,0,0,7860,7860,1
5748,C,7860,0,7860,0,0,0,7860,0
5748,G,7948,0,0,7948,0,0,7948,0
5749,C,7949,0,7939,0,0,1,7939,10
5749,G,7857,0,0,7854,0,0,7854,3
5750,C,7950,2,7947,0,0,0,7947,3
5750,G,7857,0,0,7857,0,0,7857,0
5751,G,7950,0,0,7939,0,0,7939,11
5751,T,7857,0,0,0,0,7857,7857,0
5752,C,7856,0,7855,0,0,0,7855,1
5752,G,7960,0,0,7960,0,0,7960,0
5753,A,7960,7958,0,1,0,1,7958,2
5753,G,7860,2,0,7858,0,0,7858,2
5754,C,7915,1,7912,0,0,0,7912,3
5754,G,7961,1,0,7957,0,0,7957,4
5755,A,7960,7952,0,2,0,0,7952,8
5755,C,7915,2,7913,0,0,0,7913,2
5756,A,7963,7963,0,0,0,0,7963,0
5756,G,7923,0,0,7923,0,0,7923,0
5757,C,7927,0,7925,0,0,2,7925,2
5757,C,7972,1,7964,0,0,2,7964,8
5758,A,7931,7930,0,0,0,0,7930,1
5758,C,7971,1,7970,0,0,0,7970,1
5759,T,7930,1,0,0,0,7928,7928,2
5759,T,7968,1,0,0,0,7967,7967,1
5760,A,7953,7951,0,1,0,0,7951,2
5760,G,7972,1,0,7971,0,0,7971,1
5761,C,7967,0,7966,0,0,1,7966,1
5761,C,7969,0,7969,0,0,0,7969,0
5762,A,7962,7961,0,0,0,0,7961,1
5762,G,7973,0,1,7970,0,0,7970,3
5763,C,7965,0,7961,0,0,0,7961,4
5763,T,7971,0,0,0,0,7971,7971,0
5764,G,7972,0,0,7972,0,0,7972,0
5764,T,7922,0,1,0,0,7920,7920,2
5765,A,7935,7934,1,0,0,0,7934,1
5765,C,7979,1,7975,0,0,3,7975,4
5766,A,7972,7960,0,0,0,1,7960,12
5766,T,7933,0,0,0,0,7929,7929,4
5767,A,7973,7972,0,0,0,1,7972,1
5767,T,7943,0,0,0,0,7943,7943,0
5768,C,7943,1,7939,1,0,1,7939,4
5768,T,7975,0,1,0,0,7974,7974,1
5769,C,7981,0,7978,0,0,0,7978,3
5769,T,7930,0,0,0,0,7929,7929,1
5770,C,7934,1,7932,0,0,1,7932,2
5770,C,7981,3,7978,0,0,0,7978,3
5771,A,7920,7920,0,0,0,0,7920,0
5771,A,7994,7993,0,0,0,0,7993,1
5772,G,7923,0,0,7923,0,0,7923,0
5772,T,7994,0,1,0,0,7992,7992,2
5773,A,7919,7916,0,1,0,0,7916,3
5773,C,7995,0,7995,0,0,0,7995,0
5774,A,7900,7899,1,0,0,0,7899,1
5774,T,7991,0,2,0,0,7989,7989,2
5775,T,7904,1,0,0,0,7902,7902,2
5775,T,7989,0,1,0,0,7988,7988,1
5776,G,7899,1,0,7898,0,0,7898,1
5776,G,7995,0,0,7994,0,1,7994,1
5777,A,7904,7904,0,0,0,0,7904,0
5777,T,7991,1,0,1,0,7987,7987,4
5778,C,7906,0,7905,0,0,1,7905,1
5778,T,7990,0,0,0,0,7990,7990,0
5779,C,7989,0,7986,0,0,1,7986,3
5779,T,7899,2,1,0,0,7896,7896,3
5780,A,7978,7976,0,1,0,0,7976,2
5780,T,7900,0,0,0,0,7900,7900,0
5781,A,7983,7981,1,0,0,1,7981,2
5781,G,7901,0,0,7897,0,0,7897,4
5782,G,7909,1,0,7908,0,0,7908,1
5782,T,7983,0,0,0,0,7983,7983,0
5783,C,7982,0,7981,0,0,1,7981,1
5783,T,7909,0,0,0,0,7905,7905,4
5784,A,7986,7985,0,1,0,0,7985,1
5784,T,7904,0,2,0,0,7902,7902,2
5785,G,7908,0,0,7907,0,0,7907,1
5785,T,7977,0,1,0,0,7976,7976,1
5786,A,7901,7900,0,0,0,0,7900,1
5786,G,7977,0,0,7975,0,0,7975,2
5787,C,7975,0,7974,0,0,1,7974,1
5787,G,7937,0,0,7937,0,0,7937,0
5788,G,7975,0,0,7974,0,0,7974,1
5788,T,7934,0,0,0,0,7934,7934,0
5789,A,7940,7939,0,1,0,0,7939,1
5789,A,7981,7975,0,0,0,0,7975,6
5790,A,7975,7974,0,1,0,0,7974,1
5790,T,7935,0,4,0,0,7931,7931,4
5791,A,7975,7973,0,1,0,1,7973,2
5791,T,7924,0,0,0,0,7924,7924,0
5792,C,7928,0,7925,0,0,2,7925,3
5792,C,7973,0,7973,0,0,0,7973,0
5793,A,7928,7928,0,0,0,0,7928,0
5793,G,7971,1,0,7969,0,1,7969,2
5794,A,7981,7980,0,0,0,0,7980,1
5794,C,7930,0,7927,0,0,1,7927,3
5795,C,7927,0,7924,0,0,3,7924,3
5795,T,7999,0,0,0,0,7999,7999,0
5796,A,7905,7905,0,0,0,0,7905,0
5796,C,8000,0,7998,0,0,0,7998,2
5797,C,8000,1,7999,0,0,0,7999,1
5797,G,7911,1,0,7910,0,0,7910,1
5798,T,7912,0,0,0,0,7912,7912,0
5798,T,7991,0,0,0,0,7990,7990,1
5799,C,7911,0,7911,0,0,0,7911,0
5799,C,7995,1,7991,0,0,1,7991,4
5800,A,7910,7910,0,0,0,0,7910,0
5800,A,7996,7994,0,1,0,0,7994,2
5801,C,7920,0,7920,0,0,0,7920,0
5801,T,7998,0,0,0,0,7998,7998,0
5802,A,7920,7919,0,0,0,1,7919,1
5802,C,8000,0,7992,0,0,1,7992,8
5803,C,7989,0,7989,0,0,0,7989,0
5803,G,7929,0,0,7929,0,0,7929,0
5804,A,7929,7906,0,0,0,0,7906,23
5804,T,7965,0,0,1,0,7964,7964,1
5805,A,7928,7928,0,0,0,0,7928,0
5805,G,7968,1,0,7966,0,1,7966,2
5806,A,7926,7926,0,0,0,0,7926,0
5806,T,7966,0,1,0,0,7965,7965,1
5807,A,7925,7924,0,1,0,0,7924,1
5807,C,7998,0,7998,0,0,0,7998,0
5808,G,7936,0,0,7936,0,0,7936,0
5808,T,7993,0,2,0,0,7991,7991,2
5809,C,7937,0,7937,0,0,0,7937,0
5809,C,7997,0,7997,0,0,0,7997,0
5810,A,7933,7933,0,0,0,0,7933,0
5810,T,7996,0,0,0,0,7995,7995,1
5811,T,7933,0,0,0,0,7933,7933,0
5811,T,7991,0,0,0,0,7991,7991,0
5812,C,7934,0,7934,0,0,0,7934,0
5812,G,7999,0,0,7999,0,0,7999,0
5813,A,7998,7995,1,1,0,1,7995,3
5813,T,7933,0,0,0,0,7924,7924,9
5814,T,7932,0,0,0,0,7932,7932,0
5814,T,7990,0,0,0,0,7990,7990,0
5815,A,7933,7930,0,2,0,0,7930,3
5815,C,7990,0,7990,0,0,0,7990,0
5816,A,7957,7956,0,1,0,0,7956,1
5816,C,7933,0,7933,0,0,0,7933,0
5817,G,7925,0,0,7922,0,2,7922,3
5817,G,7964,0,0,7964,0,0,7964,0
5818,A,7958,7957,0,0,0,0,7957,1
5818,G,7925,0,0,7925,0,0,7925,0
5819,A,7914,7913,0,1,0,0,7913,1
5819,T,7959,1,0,0,0,7958,7958,1
5820,C,7958,0,7953,0,0,0,7953,5
5820,T,7920,0,0,0,0,7920,7920,0
5821,C,7955,0,7954,1,0,0,7954,1
5821,G,7915,1,0,7907,0,0,7907,8
5822,G,7926,1,0,7925,0,0,7925,1
5822,G,7956,1,0,7955,0,0,7955,1
5823,A,7957,7920,0,0,0,0,7920,37
5823,C,7930,0,7930,0,0,0,7930,0
5824,A,7930,7927,1,0,0,0,7927,3
5824,A,7957,7957,0,0,0,0,7957,0
5825,A,7957,7957,0,0,0,0,7957,0
5825,T,7930,0,2,0,0,7928,7928,2
5826,A,7952,7952,0,0,0,0,7952,0
5826,G,7936,1,0,7934,0,0,7934,2
5827,A,7936,7935,0,1,0,0,7935,1
5827,T,7956,0,0,0,0,7953,7953,3
5828,C,7962,0,7961,0,0,1,7961,1
5828,G,7966,1,0,7963,0,0,7963,3
5829,A,7944,7944,0,0,0,0,7944,0
5829,G,7965,2,0,7963,0,0,7963,2
5830,A,7967,7962,0,1,0,0,7962,5
5830,G,7954,1,0,7952,0,1,7952,2
5831,T,7940,0,0,0,0,7940,7940,0
5831,T,7967,0,0,0,0,7966,7966,1
5832,A,7939,7931,0,0,0,0,7931,8
5832,A,7972,7971,0,1,0,0,7971,1
5833,A,7940,7940,0,0,0,0,7940,0
5833,T,7978,0,0,0,0,7978,7978,0
5834,A,7979,7977,0,1,0,0,7977,2
5834,G,7940,1,0,7938,0,1,7938,2
5835,A,7936,7933,0,1,0,1,7933,3
5835,C,7978,0,7977,0,0,0,7977,1
5836,A,7966,7959,1,3,0,0,7959,7
5836,G,7980,0,0,7980,0,0,7980,0
5837,A,7948,7943,1,0,0,1,7943,5
5837,A,7958,7958,0,0,0,0,7958,0
5838,A,7962,7961,0,1,0,0,7961,1
5838,G,7963,0,0,7963,0,0,7963,0
5839,C,7960,0,7959,0,0,0,7959,1
5839,T,7958,0,0,1,0,7954,7954,4
5840,T,7947,1,1,0,0,7945,7945,2
5840,T,7956,0,1,0,0,7954,7954,2
5841,A,7953,7952,0,1,0,0,7952,1
5841,C,7960,0,7901,0,0,1,7901,59
5842,C,7954,0,7954,0,0,0,7954,0
5842,T,7950,0,1,0,0,7949,7949,1
5843,C,7954,0,7949,0,0,0,7949,5
5843,G,7952,0,0,7952,0,0,7952,0
5844,C,7949,0,7949,0,0,0,7949,0
5844,G,7949,1,0,7899,0,0,7899,50
5845,A,7889,7889,0,0,0,0,7889,0
5845,G,7955,3,0,7952,0,0,7952,3
5846,G,7921,0,0,7920,0,0,7920,1
5846,G,7955,0,0,7955,0,0,7955,0
5847,A,7956,7954,1,0,0,0,7954,2
5847,T,7904,0,0,0,0,7904,7904,0
5848,G,7904,1,0,7903,0,0,7903,1
5848,G,7957,1,0,7956,0,0,7956,1
5849,C,7904,1,7903,0,0,0,7903,1
5849,C,7956,0,7956,0,0,0,7956,0
5850,T,7893,0,1,0,0,7892,7892,1
5850,T,7952,0,1,0,0,7904,7904,48
5851,G,7931,2,0,7929,0,0,7929,2
5851,T,7952,0,0,0,0,7952,7952,0
5852,C,7934,0,7930,0,0,2,7930,4
5852,T,7952,1,0,0,0,7951,7951,1
5853,C,7935,0,7934,0,0,1,7934,1
5853,T,7953,0,1,0,0,7952,7952,1
5854,A,7935,7934,0,0,0,0,7934,1
5854,T,7953,0,1,0,0,7952,7952,1
5855,G,7955,1,0,7954,0,0,7954,1
5855,T,7906,0,0,0,0,7905,7905,1
5856,A,7934,7930,0,0,0,0,7930,4
5856,C,7955,0,7954,0,0,1,7954,1
5857,A,7934,7933,0,1,0,0,7933,1
5857,A,7954,7924,0,0,0,0,7924,30
5858,A,7953,7953,0,0,0,0,7953,0
5858,C,7942,0,7939,0,0,0,7939,3
5859,A,7954,7952,1,0,0,1,7952,2
5859,C,7942,0,7942,0,0,0,7942,0
5860,A,7920,7920,0,0,0,0,7920,0
5860,A,7968,7966,0,1,0,0,7966,2
5861,G,7982,0,0,7982,0,0,7982,0
5861,T,7902,0,0,0,0,7901,7901,1
5862,C,7983,0,7974,0,0,0,7974,9
5862,G,7909,0,0,7907,0,1,7907,2
5863,A,7916,7914,0,1,0,0,7914,2
5863,C,7982,2,7980,0,0,0,7980,2
5864,G,7956,0,0,7955,0,0,7955,1
5864,T,7980,0,0,0,0,7979,7979,1
5865,A,7981,7981,0,0,0,0,7981,0
5865,T,7959,0,0,0,0,7959,7959,0
5866,G,7952,0,0,7951,0,0,7951,1
5866,G,7982,0,0,7972,0,0,7972,10
5867,A,7947,7947,0,0,0,0,7947,0
5867,G,7982,1,0,7981,0,0,7981,1
5868,C,7982,0,7976,0,0,1,7976,6
5868,T,7949,0,0,0,0,7949,7949,0
5869,A,7950,7946,1,1,0,0,7946,4
5869,C,7958,0,7956,0,0,1,7956,2
5870,A,7952,7952,0,0,0,0,7952,0
5870,T,7944,0,0,0,0,7943,7943,1
5871,C,7947,0,7941,0,0,1,7941,6
5871,C,7955,0,7954,0,0,1,7954,1
5872,A,7930,7927,0,2,0,0,7927,3
5872,C,7947,1,7943,0,0,0,7943,4
5873,A,7945,7794,3,1,0,0,7794,151
5873,C,7931,0,7931,0,0,0,7931,0
5874,A,7944,7944,0,0,0,0,7944,0
5874,T,7873,2,0,0,0,7871,7871,2
5875,A,7947,7947,0,0,0,0,7947,0
5875,G,7875,0,0,7875,0,0,7875,0
5876,A,7946,7945,0,0,0,1,7945,1
5876,C,7873,0,7869,0,0,3,7869,4
5877,A,7946,7945,1,0,0,0,7945,1
5877,G,7873,0,1,7870,0,0,7870,3
5878,A,7947,7945,0,2,0,0,7945,2
5878,G,7874,1,0,7873,0,0,7873,1
5879,C,7872,1,7866,0,0,0,7866,6
5879,G,7945,1,1,7943,0,0,7943,2
5880,C,7867,1,7864,0,0,0,7864,3
5880,C,7941,0,7930,1,0,0,7930,11
5881,A,7866,7853,0,0,0,0,7853,13
5881,C,7939,0,7939,0,0,0,7939,0
5882,A,7876,7876,0,0,0,0,7876,0
5882,T,7934,0,0,0,0,7934,7934,0
5883,C,7876,0,7875,0,0,1,7875,1
5883,C,7949,0,7946,0,0,0,7946,3
5884,C,7949,1,7947,0,0,1,7947,2
5884,T,7875,0,1,0,0,7870,7870,5
5885,T,7875,1,0,0,0,7874,7874,1
5885,T,7947,0,0,0,0,7946,7946,1
5886,A,7877,7877,0,0,0,0,7877,0
5886,C,7956,0,7956,0,0,0,7956,0
5887,A,7955,7952,0,0,0,0,7952,3
5887,C,7875,0,7875,0,0,0,7875,0
5888,C,7959,0,7958,0,0,1,7958,1
5888,T,7873,0,0,0,0,7872,7872,1
5889,T,7874,0,0,0,0,7874,7874,0
5889,T,7959,0,1,0,0,7957,7957,2
5890,A,7963,7963,0,0,0,0,7963,0
5890,C,7873,0,7873,0,0,0,7873,0
5891,C,7977,1,7976,0,0,0,7976,1
5891,T,7859,0,0,0,0,7859,7859,0
5892,G,7860,0,0,7860,0,0,7860,0
5892,T,7977,0,1,0,0,7975,7975,2
5893,A,7860,7860,0,0,0,0,7860,0
5893,T,7977,0,0,0,0,7977,7977,0
5894,C,7861,0,7860,0,0,1,7860,1
5894,C,7976,0,7976,0,0,0,7976,0
5895,A,7857,7854,1,0,0,0,7854,3
5895,T,7972,0,1,0,0,7970,7970,2
5896,A,7856,7854,0,1,0,1,7854,2
5896,G,7972,1,0,7967,0,0,7967,5
5897,C,7864,0,7862,0,0,2,7862,2
5897,G,7974,0,0,7974,0,0,7974,0
5898,A,7974,7970,0,1,0,0,7970,4
5898,G,7868,1,1,7866,0,0,7866,2
5899,A,7869,7868,0,0,0,1,7868,1
5899,A,7970,7970,0,0,0,0,7970,0
5900,T,7872,1,1,1,0,7867,7867,5
5900,T,7967,1,0,0,0,7966,7966,1
5901,A,7947,7945,0,0,0,1,7945,2
5901,T,7870,0,1,0,0,7869,7869,1
5902,G,7871,0,0,7865,0,0,7865,6
5902,G,7968,2,0,7966,0,0,7966,2
5903,C,7970,0,7966,0,0,2,7966,4
5903,G,7870,1,0,7869,0,0,7869,1
5904,A,7868,7866,1,1,0,0,7866,2
5904,T,7970,0,0,0,0,7970,7970,0
5905,C,7971,0,7971,0,0,0,7971,0
5905,G,7866,1,0,7854,0,0,7854,12
5906,A,7961,7960,0,0,0,0,7960,1
5906,G,7860,0,0,7860,0,0,7860,0
5907,A,7857,7856,0,1,0,0,7856,1
5907,G,7963,0,0,7963,0,0,7963,0
5908,A,7967,7966,0,0,0,0,7966,1
5908,C,7865,0,7861,0,0,0,7861,4
5909,C,7858,1,7857,0,0,0,7857,1
5909,G,7970,0,0,7958,0,0,7958,12
5910,G,7859,0,0,7859,0,0,7859,0
5910,G,7969,0,0,7969,0,0,7969,0
5911,A,7859,7856,0,1,0,0,7856,3
5911,C,7943,0,7942,0,0,1,7942,1
5912,A,7858,7858,0,0,0,0,7858,0
5912,A,7933,7926,4,2,0,0,7926,7
5913,G,7859,1,0,7854,0,0,7854,5
5913,G,7934,0,0,7934,0,0,7934,0
5914,A,7931,7931,0,0,0,0,7931,0
5914,G,7862,0,0,7861,0,1,7861,1
5915,A,7850,7848,0,1,0,0,7848,2
5915,G,7931,1,0,7922,0,2,7922,9
5916,G,7851,0,0,7849,0,0,7849,2
5916,G,7926,0,0,7926,0,0,7926,0
5917,C,7846,0,7844,0,0,2,7844,2
5917,C,7913,0,7911,0,0,1,7911,2
5918,G,7909,2,0,7904,0,1,7904,5
5918,T,7838,0,0,0,0,7838,7838,0
5919,A,7837,7831,0,0,0,1,7831,6
5919,G,7923,1,0,7921,0,1,7921,2
5920,A,7834,7833,1,0,0,0,7833,1
5920,C,7923,0,7914,1,0,0,7914,9
5921,C,7835,1,7828,0,0,0,7828,7
5921,C,7923,0,7923,0,0,0,7923,0
5922,C,7834,0,7833,0,0,1,7833,1
5922,T,7921,1,0,0,0,7920,7920,1
5923,C,7924,0,7922,1,0,1,7922,2
5923,G,7834,1,0,7833,0,0,7833,1
5924,C,7834,0,7832,0,0,2,7832,2
5924,G,7924,2,0,7918,0,0,7918,6
5925,G,7926,0,0,7926,0,0,7926,0
5925,T,7834,0,1,0,0,7663,7663,171
5926,C,7926,1,7916,1,0,0,7916,10
5926,T,7835,1,0,0,0,7834,7834,1
5927,C,7927,0,7925,0,0,1,7925,2
5927,T,7837,0,0,0,0,7837,7837,0
5928,T,7837,0,0,0,0,7837,7837,0
5928,T,7909,0,1,0,0,7908,7908,1
5929,C,7921,1,7919,0,0,1,7919,2
5929,T,7840,0,0,0,0,7840,7840,0
5930,T,7841,0,1,1,0,7839,7839,2
5930,T,7920,0,2,0,0,7918,7918,2
5931,G,7843,1,0,7841,0,0,7841,2
5931,G,7922,0,0,7920,0,1,7920,2
5932,C,7842,0,7837,0,0,4,7837,5
5932,C,7921,0,7921,0,0,0,7921,0
5933,A,7840,7839,0,1,0,0,7839,1
5933,A,7919,7919,0,0,0,0,7919,0
5934,C,7854,0,7851,0,0,0,7851,3
5934,T,7916,0,0,0,0,7916,7916,0
5935,A,7851,7838,0,0,0,1,7838,13
5935,A,7914,7904,0,1,0,1,7904,10
5936,A,7910,7910,0,0,0,0,7910,0
5936,A,7914,7914,0,0,0,0,7914,0
5937,A,7914,7912,0,0,0,2,7912,2
5937,C,7917,0,7916,0,0,1,7916,1
5938,A,7919,7919,0,0,0,0,7919,0
5938,T,7901,3,4,0,0,7894,7894,7
5939,A,7901,7581,0,0,0,0,7581,320
5939,T,7920,2,0,1,0,7917,7917,3
5940,A,7896,7896,0,0,0,0,7896,0
5940,G,7918,2,0,7859,0,1,7859,59
5941,A,7899,7899,0,0,0,0,7899,0
5941,G,7924,0,0,7923,0,1,7923,1
5942,A,7900,7900,0,0,0,0,7900,0
5942,G,7926,0,0,7926,0,0,7926,0
5943,A,7899,7899,0,0,0,0,7899,0
5943,G,7915,0,0,7915,0,0,7915,0
5944,A,7902,7902,0,0,0,0,7902,0
5944,G,7916,0,0,7916,0,0,7916,0
5945,A,7841,7838,1,2,0,0,7838,3
5945,A,7902,7902,0,0,0,0,7902,0
5946,A,7902,7901,0,0,0,1,7901,1
5946,T,7852,1,0,0,0,7851,7851,1
5947,C,7852,0,7851,0,0,0,7851,1
5947,T,7902,5,0,0,0,7891,7891,11
5948,A,7865,7865,0,0,0,0,7865,0
5948,T,7901,0,0,0,0,7901,7901,0
5949,A,7901,7901,0,0,0,0,7901,0
5949,T,7864,0,1,1,0,7861,7861,3
5950,G,7862,2,0,7860,0,0,7860,2
5950,G,7902,0,0,7902,0,0,7902,0
5951,T,7860,0,0,0,0,7860,7860,0
5951,T,7902,0,0,0,0,7901,7901,1
5952,A,7849,7848,0,0,0,0,7848,1
5952,C,7907,0,7906,0,0,1,7906,1
5953,A,7847,7846,0,1,0,0,7846,1
5953,A,7905,7905,0,0,0,0,7905,0
5954,C,7846,1,7845,0,0,0,7845,1
5954,G,7921,1,0,7920,0,0,7920,1
5955,C,7921,0,7916,0,0,1,7916,5
5955,T,7818,0,1,0,0,7817,7817,1
5956,C,7812,0,7812,0,0,0,7812,0
5956,C,7919,0,7919,0,0,0,7919,0
5957,A,7919,7918,1,0,0,0,7918,1
5957,G,7807,3,0,7804,0,0,7804,3
5958,C,7813,0,7807,0,0,0,7807,6
5958,T,7918,0,0,1,0,7916,7916,2
5959,C,7813,1,7810,0,0,1,7810,3
5959,G,7918,1,0,7833,0,0,7833,85
5960,G,7918,0,0,7918,0,0,7918,0
5960,T,7811,0,1,0,0,7809,7809,2
5961,G,7925,1,0,7924,0,0,7924,1
5961,T,7811,0,0,0,0,7811,7811,0
5962,G,7816,0,0,7816,0,0,7816,0
5962,G,7925,2,2,7921,0,0,7921,4
5963,A,7816,7816,0,0,0,0,7816,0
5963,C,7901,1,7896,4,0,0,7896,5
5964,G,7901,0,1,7895,0,1,7895,6
5964,T,7820,1,0,0,0,7819,7819,1
5965,C,7811,0,7810,0,0,0,7810,1
5965,G,7906,0,0,7906,0,0,7906,0
5966,A,7905,7904,0,1,0,0,7904,1
5966,G,7813,0,0,7813,0,0,7813,0
5967,G,7909,0,0,7909,0,0,7909,0
5967,T,7808,0,0,0,0,7803,7803,5
5968,A,7905,7897,0,0,0,0,7897,8
5968,T,7808,0,0,0,0,7807,7807,1
5969,A,7901,7901,0,0,0,0,7901,0
5969,G,7807,1,0,7773,0,0,7773,34
5970,G,7808,0,0,7808,0,0,7808,0
5970,T,7893,1,0,1,0,7890,7890,3
5971,G,7806,1,0,7804,0,0,7804,2
5971,G,7902,1,0,7859,0,0,7859,43
5972,A,7806,7796,0,0,0,0,7796,10
5972,G,7901,0,0,7901,0,0,7901,0
5973,A,7804,7804,0,0,0,0,7804,0
5973,G,7901,0,0,7900,0,0,7900,1
5974,C,7805,2,7798,0,0,0,7798,7
5974,C,7894,1,7889,0,0,3,7889,5
5975,C,7799,0,7798,0,0,0,7798,1
5975,G,7894,1,1,7884,0,0,7884,10
5976,G,7796,0,0,7787,0,0,7787,9
5976,G,7900,0,1,7898,0,1,7898,2
5977,A,7897,7892,0,0,0,0,7892,5
5977,G,7801,1,0,7799,0,0,7799,2
5978,A,7800,7800,0,0,0,0,7800,0
5978,A,7898,7897,0,0,0,0,7897,1
5979,C,7897,0,7896,0,0,1,7896,1
5979,G,7801,0,0,7801,0,0,7801,0
5980,C,7799,0,7799,0,0,0,7799,0
5980,T,7880,0,1,1,0,7876,7876,4
5981,G,7878,0,0,7827,0,0,7827,51
5981,T,7794,0,1,0,0,7793,7793,1
5982,G,7822,0,0,7822,0,0,7822,0
5982,G,7875,0,0,7873,0,1,7873,2
5983,A,7819,7816,0,0,0,0,7816,3
5983,G,7875,0,0,7874,0,0,7874,1
5984,A,7819,7819,0,0,0,0,7819,0
5984,C,7874,0,7872,0,0,1,7872,2
5985,G,7854,1,0,7841,0,0,7841,13
5985,T,7819,0,0,0,0,7819,7819,0
5986,G,7813,0,0,7813,0,0,7813,0
5986,G,7872,0,0,7870,0,1,7870,2
5987,A,7819,7817,0,0,0,0,7817,2
5987,A,7874,7874,0,0,0,0,7874,0
5988,A,7819,7819,0,0,0,0,7819,0
5988,G,7883,0,0,7881,0,1,7881,2
5989,G,7820,0,0,7820,0,0,7820,0
5989,T,7883,0,1,0,0,7876,7876,7
5990,C,7820,0,7814,0,0,0,7814,6
5990,T,7877,0,2,0,0,7875,7875,2
5991,A,7878,7876,0,2,0,0,7876,2
5991,C,7792,0,7790,0,0,1,7790,2
5992,A,7794,7792,0,0,0,0,7792,2
5992,G,7880,0,0,7783,0,0,7783,97
5993,G,7880,0,0,7878,0,2,7878,2
5993,T,7793,0,0,0,0,7793,7793,0
5994,A,7799,7798,0,1,0,0,7798,1
5994,G,7880,0,0,7880,0,0,7880,0
5995,C,7801,0,7795,0,0,1,7795,6
5995,G,7855,0,1,7854,0,0,7854,1
5996,C,7790,1,7789,0,0,0,7789,1
5996,C,7842,0,7837,4,0,1,7837,5
5997,A,7787,7774,1,1,0,0,7774,13
5997,G,7830,1,3,7777,0,0,7777,53
5998,A,7787,7785,1,0,0,1,7785,2
5998,G,7832,0,0,7832,0,0,7832,0
5999,A,7787,7786,0,1,0,0,7786,1
5999,G,7832,2,0,7830,0,0,7830,2
6000,A,7832,7830,0,1,0,0,7830,2
6000,C,7787,0,7785,0,0,1,7785,2
6001,G,7780,0,0,7780,0,0,7780,0
6001,T,7829,0,0,1,0,7824,7824,5
6002,A,7781,7781,0,0,0,0,7781,0
6002,G,7826,1,0,7796,0,0,7796,30
6003,C,7773,0,7771,0,0,1,7771,2
6003,G,7829,1,0,7828,0,0,7828,1
6004,G,7773,1,0,7772,0,0,7772,1
6004,G,7831,0,2,7829,0,0,7829,2
6005,A,7772,7770,0,2,0,0,7770,2
6005,C,7831,0,7829,1,0,0,7829,2
6006,G,7778,0,0,7776,0,0,7776,2
6006,G,7829,0,0,7815,0,0,7815,14
6007,C,7776,0,7775,0,0,1,7775,1
6007,G,7842,1,0,7841,0,0,7841,1
6008,A,7842,7841,0,0,0,1,7841,1
6008,G,7775,0,0,7774,0,1,7774,1
6009,G,7853,0,0,7851,0,0,7851,2
6009,T,7778,0,1,0,0,7777,7777,1
6010,G,7778,0,0,7778,0,0,7778,0
6010,T,7850,0,0,1,0,7842,7842,8
6011,A,7780,7779,0,1,0,0,7779,1
6011,T,7851,0,0,1,0,7850,7850,1
6012,A,7845,7840,2,1,0,0,7840,5
6012,C,7782,0,7779,0,0,3,7779,3
6013,A,7781,7780,0,0,0,0,7780,1
6013,G,7844,0,0,7741,0,0,7741,103
6014,C,7785,0,7779,0,0,0,7779,6
6014,G,7844,1,0,7843,0,0,7843,1
6015,C,7775,0,7773,0,0,2,7773,2
6015,G,7846,0,0,7846,0,0,7846,0
6016,A,7774,7773,1,0,0,0,7773,1
6016,G,7825,0,6,7819,0,0,7819,6
6017,C,7774,0,7773,0,0,1,7773,1
6017,C,7811,0,7806,5,0,0,7806,5
6018,G,7769,1,0,7768,0,0,7768,1
6018,G,7789,1,0,7771,0,1,7771,18
6019,A,7769,7769,0,0,0,0,7769,0
6019,G,7827,0,0,7827,0,0,7827,0
6020,G,7843,0,0,7843,0,0,7843,0
6020,T,7763,0,0,0,0,7763,7763,0
6021,A,7844,7843,0,0,0,0,7843,1
6021,G,7786,0,0,7786,0,0,7786,0
6022,C,7786,0,7773,0,0,0,7773,13
6022,C,7846,0,7846,0,0,0,7846,0
6023,C,7778,0,7777,0,0,1,7777,1
6023,T,7841,0,0,0,0,7839,7839,2
6024,A,7840,7839,0,1,0,0,7839,1
6024,T,7773,0,0,0,0,7773,7773,0
6025,G,7772,0,0,7772,0,0,7772,0
6025,T,7843,0,1,1,0,7840,7840,3
6026,G,7842,1,0,7839,0,0,7839,3
6026,T,7773,0,0,0,0,7773,7773,0
6027,A,7773,7773,0,0,0,0,7773,0
6027,G,7842,0,0,7842,0,0,7842,0
6028,G,7774,0,0,7774,0,0,7774,0
6028,T,7779,0,0,1,0,7769,7769,10
6029,C,7771,0,7771,0,0,0,7771,0
6029,T,7761,0,0,1,0,7760,7760,1
6030,A,7743,7742,1,0,0,0,7742,1
6030,G,7762,1,0,7761,0,0,7761,1
6031,A,7742,7742,0,0,0,0,7742,0
6031,C,7763,0,7760,0,0,2,7760,3
6032,T,7731,0,0,0,0,7731,7731,0
6032,T,7761,2,0,0,0,7759,7759,2
6033,G,7739,0,0,7738,0,1,7738,1
6033,G,7771,2,0,7769,0,0,7769,2
6034,A,7768,7766,0,1,0,0,7766,2
6034,G,7740,1,0,7739,0,0,7739,1
6035,C,7742,0,7742,0,0,0,7742,0
6035,C,7767,0,7765,0,0,1,7765,2
6036,A,7741,7736,0,1,0,0,7736,5
6036,T,7762,0,0,0,0,7762,7762,0
6037,A,7741,7740,1,0,0,0,7740,1
6037,A,7761,7755,0,0,0,0,7755,6
6038,A,7767,7767,0,0,0,0,7767,0
6038,C,7743,0,7743,0,0,0,7743,0
6039,A,7744,7737,0,1,0,0,7737,7
6039,T,7767,0,0,0,0,7761,7761,6
6040,A,7751,7750,1,0,0,0,7750,1
6040,T,7765,0,2,0,0,7763,7763,2
6041,C,7751,0,7748,0,0,0,7748,3
6041,G,7765,0,0,7764,0,0,7764,1
6042,A,7747,7745,0,0,0,1,7745,2
6042,C,7736,0,7736,0,0,0,7736,0
6043,G,7753,1,1,7751,0,0,7751,2
6043,T,7734,0,0,0,0,7731,7731,3
6044,A,7752,7751,0,0,0,0,7751,1
6044,T,7727,0,0,1,0,7726,7726,1
6045,G,7728,0,0,7728,0,0,7728,0
6045,T,7752,0,0,0,0,7750,7750,2
6046,C,7728,0,7728,0,0,0,7728,0
6046,G,7750,3,0,7747,0,0,7747,3
6047,C,7745,0,7743,0,0,2,7743,2
6047,G,7727,0,1,7724,0,0,7724,3
6048,A,7741,7740,0,1,0,0,7740,1
6048,T,7726,0,0,0,0,7726,7726,0
6049,A,7713,7706,0,0,0,0,7706,7
6049,T,7741,0,0,0,0,7741,7741,0
6050,A,7711,7711,0,0,0,0,7711,0
6050,G,7744,0,0,7744,0,0,7744,0
6051,A,7711,7711,0,0,0,0,7711,0
6051,C,7750,0,7749,0,0,1,7749,1
6052,C,7726,0,7725,0,0,1,7725,1
6052,T,7738,0,0,0,0,7734,7734,4
6053,T,7717,0,0,0,0,7716,7716,1
6053,T,7746,0,0,0,0,7746,7746,0
6054,A,7717,7717,0,0,0,0,7717,0
6054,T,7743,1,0,0,0,7742,7742,1
6055,G,7753,3,0,7750,0,0,7750,3
6055,T,7716,2,0,0,0,7709,7709,7
6056,C,7752,0,7750,1,0,1,7750,2
6056,T,7717,0,1,0,0,7716,7716,1
6057,A,7716,7711,0,0,0,1,7711,5
6057,A,7751,7751,0,0,0,0,7751,0
6058,A,7716,7715,0,0,0,1,7715,1
6058,T,7751,0,1,0,0,7750,7750,1
6059,A,7738,7738,0,0,0,0,7738,0
6059,C,7718,0,7718,0,0,0,7718,0
6060,C,7747,0,7747,0,0,0,7747,0
6060,T,7711,0,1,0,0,7710,7710,1
6061,G,7691,0,0,7690,0,0,7690,1
6061,T,7732,0,0,0,0,7731,7731,1
6062,G,7692,1,0,7691,0,0,7691,1
6062,T,7730,0,1,0,0,7726,7726,4
6063,C,7686,0,7685,0,0,0,7685,1
6063,C,7726,0,7726,0,0,0,7726,0
6064,G,7685,0,0,7685,0,0,7685,0
6064,T,7707,1,0,0,0,7706,7706,1
6065,A,7684,7683,0,0,0,0,7683,1
6065,G,7708,1,0,7707,0,0,7707,1
6066,A,7684,7684,0,0,0,0,7684,0
6066,C,7708,0,7684,0,0,0,7684,24
6067,C,7696,0,7696,0,0,0,7696,0
6067,C,7713,0,7711,1,0,0,7711,2
6068,T,7696,0,0,0,0,7695,7695,1
6068,T,7704,0,2,0,0,7702,7702,2
6069,A,7705,7705,0,0,0,0,7705,0
6069,G,7687,0,0,7687,0,0,7687,0
6070,C,7687,0,7685,0,0,0,7685,2
6070,C,7704,0,7704,0,0,0,7704,0
6071,T,7683,0,1,0,0,7681,7681,2
6071,T,7704,0,1,0,0,7702,7702,2
6072,G,7684,1,0,7607,0,0,7607,77
6072,T,7705,0,0,0,0,7705,7705,0
6073,A,7707,7705,0,0,0,0,7705,2
6073,G,7684,0,0,7684,0,0,7684,0
6074,C,7711,0,7711,0,0,0,7711,0
6074,G,7685,0,0,7685,0,0,7685,0
6075,G,7685,2,0,7683,0,0,7683,2
6075,T,7711,0,0,0,0,7711,7711,0
6076,A,7673,7668,0,3,0,0,7668,5
6076,C,7696,0,7696,0,0,0,7696,0
6077,G,7682,1,0,7681,0,0,7681,1
6077,T,7693,1,0,0,0,7692,7692,1
6078,A,7673,7672,0,1,0,0,7672,1
6078,C,7676,0,7672,0,0,1,7672,4
6079,C,7675,0,7674,0,0,1,7674,1
6079,G,7674,1,0,7673,0,0,7673,1
6080,C,7675,1,7674,0,0,0,7674,1
6080,T,7674,0,0,1,0,7672,7672,2
6081,G,7673,1,0,7609,0,0,7609,64
6081,T,7665,0,0,0,0,7665,7665,0
6082,G,7673,0,1,7672,0,0,7672,1
6082,T,7657,0,0,0,0,7656,7656,1
6083,C,7653,0,7570,0,0,0,7570,83
6083,G,7673,0,0,7672,0,1,7672,1
6084,C,7654,0,7654,0,0,0,7654,0
6084,G,7674,1,0,7673,0,0,7673,1
6085,A,7669,7665,0,3,0,1,7665,4
6085,C,7654,0,7652,1,0,0,7652,2
6086,C,7661,1,7660,0,0,0,7660,1
6086,G,7654,0,0,7651,0,1,7651,3
6087,G,7655,1,0,7654,0,0,7654,1
6087,T,7631,0,0,0,0,7626,7626,5
6088,C,7657,0,7657,0,0,0,7657,0
6088,T,7640,0,0,1,0,7639,7639,1
6089,A,7654,7650,1,1,0,0,7650,4
6089,T,7640,0,0,0,0,7639,7639,1
6090,A,7658,7657,0,0,0,1,7657,1
6090,C,7639,0,7632,0,0,0,7632,7
6091,C,7641,0,7640,0,0,0,7640,1
6091,C,7661,0,7661,0,0,0,7661,0
6092,A,7637,7635,0,1,0,0,7635,2
6092,A,7657,7655,0,2,0,0,7655,2
6093,C,7643,0,7642,0,0,1,7642,1
6093,G,7668,1,0,7667,0,0,7667,1
6094,A,7640,7639,0,0,0,0,7639,1
6094,T,7668,0,1,0,0,7662,7662,6
6095,C,7641,1,7634,0,0,3,7634,7
6095,T,7666,0,1,0,0,7665,7665,1
6096,C,7638,1,7637,0,0,0,7637,1
6096,G,7667,0,0,7666,0,0,7666,1
6097,A,7666,7666,0,0,0,0,7666,0
6097,T,7602,0,0,0,0,7602,7602,0
6098,G,7603,0,0,7595,0,0,7595,8
6098,T,7666,0,0,1,0,7665,7665,1
6099,A,7665,7665,0,0,0,0,7665,0
6099,G,7600,0,0,7600,0,0,7600,0
6100,G,7666,1,0,7664,0,1,7664,2
6100,T,7600,0,0,0,0,7592,7592,8
6101,A,7658,7656,0,1,0,0,7656,2
6101,T,7599,0,0,1,0,7597,7597,2
6102,C,7659,0,7659,0,0,0,7659,0
6102,G,7596,1,0,7594,0,1,7594,2
6103,C,7595,0,7595,0,0,0,7595,0
6103,T,7626,0,0,0,0,7626,7626,0
6104,G,7637,0,0,7633,0,1,7633,4
6104,T,7581,0,2,0,0,7579,7579,2
6105,G,7591,0,0,7590,0,1,7590,1
6105,G,7636,0,0,7636,0,0,7636,0
6106,A,7591,7590,0,1,0,0,7590,1
6106,A,7636,7635,0,1,0,0,7635,1
6107,C,7592,0,7592,0,0,0,7592,0
6107,T,7636,0,1,0,0,7634,7634,2
6108,G,7633,1,0,7631,0,0,7631,2
6108,T,7590,0,0,0,0,7590,7590,0
6109,A,7589,7582,0,0,0,0,7582,7
6109,G,7630,0,0,7630,0,0,7630,0
6110,A,7594,7592,0,0,0,1,7592,2
6110,A,7622,7618,0,3,0,1,7618,4
6111,G,7621,0,0,7617,0,0,7617,4
6111,T,7593,0,1,0,0,7585,7585,8
6112,G,7621,0,2,7619,0,0,7619,2
6112,T,7594,0,0,0,0,7594,7594,0
6113,C,7600,0,7597,2,0,0,7597,3
6113,G,7594,0,0,7593,0,0,7593,1
6114,A,7573,7570,0,1,0,1,7570,3
6114,G,7603,1,0,7601,0,0,7601,2
6115,G,7577,0,1,7576,0,0,7576,1
6115,G,7603,2,0,7601,0,0,7601,2
6116,A,7576,7576,0,0,0,0,7576,0
6116,A,7603,7600,0,0,0,1,7600,3
6117,T,7574,0,0,0,0,7573,7573,1
6117,T,7602,0,2,0,0,7600,7600,2
6118,A,7602,7595,0,1,0,1,7595,7
6118,G,7571,1,0,7570,0,0,7570,1
6119,A,7603,7602,0,1,0,0,7602,1
6119,C,7561,0,7560,0,0,1,7560,1
6120,A,7561,7560,0,1,0,0,7560,1
6120,A,7603,7602,0,1,0,0,7602,1
6121,G,7603,0,0,7602,0,0,7602,1
6121,T,7562,1,0,0,0,7561,7561,1
6122,G,7566,2,0,7564,0,0,7564,2
6122,T,7603,2,0,0,0,7597,7597,6
6123,C,7570,0,7570,0,0,0,7570,0
6123,T,7585,0,2,1,0,7582,7582,3
6124,G,7586,1,0,7585,0,0,7585,1
6124,T,7554,0,0,0,0,7547,7547,7
6125,C,7586,0,7583,0,0,2,7583,3
6125,T,7555,0,0,0,0,7555,7555,0
6126,A,7585,7585,0,0,0,0,7585,0
6126,T,7554,0,0,0,0,7554,7554,0
6127,G,7561,4,0,7557,0,0,7557,4
6127,G,7585,0,0,7579,0,0,7579,6
6128,C,7561,0,7558,0,0,3,7558,3
6128,G,7587,1,0,7586,0,0,7586,1
6129,A,7560,7560,0,0,0,0,7560,0
6129,A,7587,7585,0,1,0,0,7585,2
6130,C,7582,0,7571,0,0,0,7571,11
6130,T,7561,0,0,0,0,7561,7561,0
6131,A,7552,7550,0,0,0,0,7550,2
6131,C,7579,0,7579,0,0,0,7579,0
6132,A,7579,7578,0,1,0,0,7578,1
6132,C,7556,0,7555,0,0,0,7555,1
6133,C,7583,0,7582,0,0,0,7582,1
6133,T,7541,0,1,0,0,7539,7539,2
6134,T,7539,0,1,0,0,7537,7537,2
6134,T,7581,1,1,0,0,7578,7578,3
6135,C,7537,0,7537,0,0,0,7537,0
6135,T,7582,0,0,0,0,7582,7582,0
6136,C,7581,0,7580,0,0,1,7580,1
6136,T,7512,0,0,0,0,7512,7512,0
6137,G,7512,0,0,7512,0,0,7512,0
6137,T,7561,0,0,0,0,7561,7561,0
6138,C,7511,0,7490,0,0,0,7490,21
6138,G,7563,0,0,7562,0,0,7562,1
6139,C,7511,0,7511,0,0,0,7511,0
6139,C,7561,0,7560,1,0,0,7560,1
6140,G,7560,1,1,7557,0,0,7557,3
6140,T,7506,0,0,0,0,7506,7506,0
6141,C,7560,0,7560,0,0,0,7560,0
6141,G,7484,3,0,7481,0,0,7481,3
6142,C,7484,0,7483,0,0,1,7483,1
6142,T,7529,0,0,0,0,7529,7529,0
6143,C,7532,0,7531,0,0,0,7531,1
6143,T,7480,0,1,0,0,7478,7478,2
6144,G,7480,0,0,7395,0,1,7395,85
6144,G,7532,2,0,7524,0,0,7524,8
6145,G,7480,0,0,7480,0,0,7480,0
6145,G,7532,1,0,7528,0,0,7528,4
6146,C,7529,1,7503,0,0,0,7503,26
6146,G,7478,1,0,7477,0,0,7477,1
6147,C,7528,0,7528,0,0,0,7528,0
6147,G,7478,1,0,7477,0,0,7477,1
6148,A,7467,7464,0,3,0,0,7464,3
6148,C,7527,0,7526,0,0,0,7526,1
6149,G,7473,0,0,7472,0,0,7472,1
6149,T,7525,1,0,1,0,7519,7519,6
6150,C,7473,0,7471,0,0,1,7471,2
6150,T,7526,0,1,0,0,7524,7524,2
6151,C,7471,0,7470,0,0,1,7470,1
6151,C,7525,0,7508,0,0,0,7508,17
6152,C,7526,0,7526,0,0,0,7526,0
6152,T,7471,1,1,1,0,7466,7466,5
6153,G,7468,0,0,7409,0,0,7409,59
6153,G,7526,1,0,7512,0,1,7512,14
6154,G,7468,0,0,7468,0,0,7468,0
6154,G,7522,0,0,7521,0,0,7521,1
6155,C,7521,0,7521,0,0,0,7521,0
6155,G,7468,0,0,7467,0,1,7467,1
6156,G,7469,1,0,7468,0,0,7468,1
6156,T,7515,0,0,0,0,7513,7513,2
6157,A,7464,7462,1,1,0,0,7462,2
6157,G,7515,0,0,7511,0,0,7511,4
6158,C,7456,0,7453,0,0,2,7453,3
6158,G,7516,1,0,7513,0,0,7513,3
6159,C,7514,0,7512,1,0,1,7512,2
6159,T,7438,1,0,0,0,7420,7420,18
6160,T,7441,0,1,0,0,7440,7440,1
6160,T,7514,1,1,0,0,7512,7512,2
6161,G,7521,0,0,7511,0,1,7511,10
6161,T,7446,0,0,0,0,7445,7445,1
6162,C,7444,0,7422,0,0,1,7422,22
6162,G,7525,2,0,7523,0,0,7523,2
6163,C,7445,0,7443,0,0,1,7443,2
6163,T,7525,0,0,1,0,7493,7493,32
6164,A,7442,7440,1,0,0,0,7440,2
6164,T,7525,0,0,0,0,7525,7525,0
6165,C,7444,0,7442,0,0,2,7442,2
6165,T,7525,0,0,0,0,7525,7525,0
6166,A,7437,7433,0,3,0,0,7433,4
6166,A,7520,7520,0,0,0,0,7520,0
6167,C,7450,1,7436,0,0,1,7436,14
6167,T,7520,0,0,0,0,7516,7516,4
6168,C,7446,0,7446,0,0,0,7446,0
6168,T,7520,0,0,0,0,7520,7520,0
6169,C,7424,0,7424,0,0,0,7424,0
6169,G,7523,3,0,7520,0,0,7520,3
6170,C,7518,0,7516,0,0,1,7516,2
6170,T,7413,0,2,0,0,7411,7411,2
6171,A,7414,7410,0,1,0,0,7410,4
6171,T,7492,0,1,0,0,7491,7491,1
6172,A,7414,7414,0,0,0,0,7414,0
6172,G,7498,1,0,7497,0,0,7497,1
6173,A,7498,7497,0,0,0,0,7497,1
6173,C,7418,1,7417,0,0,0,7417,1
6174,T,7406,0,1,0,0,7405,7405,1
6174,T,7497,0,0,0,0,7496,7496,1
6175,A,7497,7490,0,0,0,0,7490,7
6175,G,7406,0,0,7406,0,0,7406,0
6176,A,7378,7377,0,0,0,1,7377,1
6176,A,7496,7496,0,0,0,0,7496,0
6177,A,7498,7497,1,0,0,0,7497,1
6177,C,7379,0,7378,0,0,1,7378,1
6178,A,7375,7373,1,0,0,1,7373,2
6178,T,7494,0,0,0,0,7494,7494,0
6179,C,7375,1,7372,1,0,0,7372,3
6179,C,7494,0,7494,0,0,0,7494,0
6180,A,7369,7368,0,0,0,0,7368,1
6180,T,7491,0,0,0,0,7491,7491,0
6181,C,7369,0,7366,0,0,2,7366,3
6181,G,7486,0,0,7485,0,0,7485,1
6182,A,7362,7361,0,0,0,0,7361,1
6182,G,7486,1,0,7484,0,0,7484,2
6183,A,7483,7481,0,2,0,0,7481,2
6183,T,7363,0,0,0,0,7359,7359,4
6184,G,7485,0,0,7484,0,1,7484,1
6184,T,7359,1,1,0,0,7357,7357,2
6185,C,7360,0,7353,0,0,0,7353,7
6185,C,7481,1,7474,2,0,1,7474,7
6186,C,7355,1,7354,0,0,0,7354,1
6186,C,7471,0,7470,0,0,1,7470,1
6187,A,7354,7351,1,0,0,0,7351,3
6187,G,7471,3,0,7462,0,1,7462,9
6188,C,7353,0,7352,0,0,0,7352,1
6188,G,7471,4,1,7466,0,0,7466,5
6189,A,7338,7337,0,0,0,0,7337,1
6189,T,7471,0,0,1,0,7470,7470,1
6190,G,7345,0,0,7345,0,0,7345,0
6190,G,7471,0,0,7470,0,1,7470,1
6191,A,7341,7337,0,0,0,0,7337,4
6191,A,7470,7467,0,3,0,0,7467,3
6192,A,7338,7338,0,0,0,0,7338,0
6192,G,7476,0,0,7474,0,1,7474,2
6193,C,7471,0,7468,0,0,1,7468,3
6193,T,7338,2,0,0,0,7330,7330,8
6194,G,7471,0,0,7471,0,0,7471,0
6194,T,7334,1,1,0,0,7332,7332,2
6195,A,7333,7332,0,0,0,0,7332,1
6195,T,7470,0,1,0,0,7469,7469,1
6196,A,7333,7332,0,0,0,1,7332,1
6196,G,7465,0,0,7445,0,1,7445,20
6197,G,7466,1,0,7465,0,0,7465,1
6197,T,7333,0,0,0,0,7332,7332,1
6198,G,7467,0,0,7466,0,1,7466,1
6198,T,7332,0,0,0,0,7332,7332,0
6199,C,7296,1,7295,0,0,0,7295,1
6199,T,7465,0,0,0,0,7465,7465,0
6200,C,7465,0,7464,0,0,0,7464,1
6200,G,7296,0,0,7295,0,0,7295,1
6201,C,7296,0,7294,0,0,0,7294,2
6201,T,7457,0,1,0,0,7456,7456,1
6202,C,7457,0,7455,1,0,0,7455,2
6202,G,7296,1,0,7294,0,0,7294,2
6203,G,7457,0,0,7456,0,1,7456,1
6203,T,7296,0,1,1,0,7291,7291,5
6204,C,7459,0,7457,0,0,1,7457,2
6204,T,7296,1,0,0,0,7295,7295,1
6205,A,7296,7282,0,0,0,0,7282,14
6205,G,7459,1,0,7456,0,0,7456,3
6206,A,7295,7294,0,0,0,1,7294,1
6206,G,7459,0,1,7456,0,2,7456,3
6207,A,7296,7294,0,0,0,1,7294,2
6207,T,7450,0,0,0,0,7450,7450,0
6208,A,7448,7448,0,0,0,0,7448,0
6208,T,7295,0,0,0,0,7176,7176,119
6209,T,7294,0,0,0,0,7294,7294,0
6209,T,7447,0,0,0,0,7446,7446,1
6210,C,7449,1,7448,0,0,0,7448,1
6210,T,7294,0,0,0,0,7294,7294,0
6211,A,7441,7441,0,0,0,0,7441,0
6211,T,7294,0,1,1,0,7292,7292,2
6212,T,7295,0,0,1,0,7294,7294,1
6212,T,7448,0,0,0,0,7445,7445,3
6213,G,7295,0,0,7294,0,0,7294,1
6213,T,7438,1,0,0,0,7437,7437,1
6214,G,7437,0,0,7436,0,0,7436,1
6214,T,7295,0,0,0,0,7291,7291,4
6215,C,7420,0,7420,0,0,0,7420,0
6215,T,7295,0,0,0,0,7295,7295,0
6216,A,7295,7288,0,0,0,0,7288,7
6216,A,7413,7411,0,2,0,0,7411,2
6217,A,7295,7295,0,0,0,0,7295,0
6217,G,7422,0,0,7421,0,1,7421,1
6218,A,7295,7295,0,0,0,0,7295,0
6218,C,7419,1,7415,0,0,3,7415,4
6219,A,7414,7412,0,0,0,2,7412,2
6219,T,7295,0,0,0,0,7295,7295,0
6220,C,7295,0,7295,0,0,0,7295,0
6220,C,7414,0,7412,0,0,2,7412,2
6221,A,7288,7288,0,0,0,0,7288,0
6221,T,7378,0,0,0,0,7378,7378,0
6222,G,7290,0,0,7290,0,0,7290,0
6222,G,7379,0,0,7341,0,0,7341,38
6223,C,7290,1,7288,0,0,1,7288,2
6223,G,7378,0,0,7378,0,0,7378,0
6224,G,7383,0,0,7383,0,0,7383,0
6224,T,7290,0,0,0,0,7290,7290,0
6225,C,7290,0,7290,0,0,0,7290,0
6225,G,7384,1,1,7382,0,0,7382,2
6226,A,7290,7290,0,0,0,0,7290,0
6226,C,7365,1,7361,1,0,0,7361,4
6227,C,7364,0,7362,0,0,2,7362,2
6227,T,7296,0,0,0,0,7149,7149,147
6228,A,7358,7355,0,2,0,0,7355,3
6228,T,7296,1,0,0,0,7295,7295,1
6229,G,7359,2,0,7355,0,1,7355,4
6229,T,7297,0,0,0,0,7297,7297,0
6230,A,7364,7364,0,0,0,0,7364,0
6230,T,7297,0,0,1,0,7296,7296,1
6231,T,7291,0,1,0,0,7290,7290,1
6231,T,7371,0,0,0,0,7371,7371,0
6232,G,7365,0,0,7362,0,0,7362,3
6232,T,7290,2,1,0,0,7285,7285,5
6233,A,7288,7283,0,0,0,0,7283,5
6233,G,7357,1,0,7356,0,0,7356,1
6234,A,7290,7290,0,0,0,0,7290,0
6234,T,7353,0,0,0,0,7352,7352,1
6235,A,7353,7350,0,1,0,1,7350,3
6235,C,7292,0,7288,0,0,1,7288,4
6236,A,7352,7349,0,1,0,2,7349,3
6236,C,7289,0,7287,0,0,2,7287,2
6237,A,7282,7277,1,0,0,0,7277,5
6237,G,7354,0,0,7353,0,1,7353,1
6238,A,7282,7281,0,0,0,1,7281,1
6238,C,7348,0,7322,0,0,1,7322,26
6239,C,7328,0,7328,0,0,0,7328,0
6239,T,7282,0,0,0,0,7281,7281,1
6240,A,7282,7280,0,2,0,0,7280,2
6240,C,7294,1,7291,0,0,1,7291,3
6241,G,7282,0,0,7272,0,0,7272,10
6241,T,7288,0,0,0,0,7288,7288,0
6242,C,7290,0,7254,0,0,0,7254,36
6242,G,7279,0,0,7278,0,0,7278,1
6243,C,7278,1,7262,0,0,2,7262,16
6243,C,7288,0,7288,0,0,0,7288,0
6244,C,7274,1,7272,0,0,1,7272,2
6244,C,7288,1,7286,0,0,1,7286,2
6245,G,7272,0,0,7271,0,0,7271,1
6245,G,7294,1,0,7292,0,0,7292,2
6246,A,7272,7261,0,0,0,1,7261,11
6246,T,7282,0,0,0,0,7281,7281,1
6247,A,7271,7271,0,0,0,0,7271,0
6247,A,7283,7282,0,1,0,0,7282,1
6248,A,7272,7272,0,0,0,0,7272,0
6248,T,7283,0,0,0,0,7283,7283,0
6249,C,7267,1,7266,0,0,0,7266,1
6249,T,7272,0,0,0,0,7272,7272,0
6250,C,7272,0,7272,0,0,0,7272,0
6250,G,7270,0,0,7270,0,0,7270,0
6251,G,7270,2,0,7264,0,0,7264,6
6251,T,7257,0,0,0,0,7257,7257,0
6252,A,7256,7254,0,0,0,0,7254,2
6252,G,7270,0,0,7270,0,0,7270,0
6253,C,7270,1,7268,0,0,0,7268,2
6253,G,7258,1,0,7256,0,0,7256,2
6254,A,7269,7246,0,0,0,0,7246,23
6254,T,7240,0,0,0,0,7240,7240,0
6255,A,7269,7268,0,1,0,0,7268,1
6255,T,7238,0,0,0,0,7238,7238,0
6256,A,7238,7238,0,0,0,0,7238,0
6256,A,7269,7268,0,0,0,1,7268,1
6257,A,7268,7268,0,0,0,0,7268,0
6257,T,7236,0,0,0,0,7232,7232,4
6258,C,7237,0,7236,0,0,1,7236,1
6258,T,7267,1,0,0,0,7266,7266,1
6259,C,7268,2,7239,0,0,2,7239,29
6259,T,7220,0,0,0,0,7220,7220,0
6260,A,7219,7217,0,1,0,0,7217,2
6260,C,7268,0,7268,0,0,0,7268,0
6261,C,7219,0,7218,0,0,1,7218,1
6261,C,7264,0,7264,0,0,0,7264,0
6262,A,7205,7204,0,1,0,0,7204,1
6262,T,7265,1,0,1,0,7261,7261,4
6263,C,7206,0,7204,0,0,1,7204,2
6263,T,7265,0,0,0,0,7265,7265,0
6264,A,7265,7264,0,0,0,0,7264,1
6264,G,7182,0,0,7182,0,0,7182,0
6265,A,7178,7176,0,1,0,0,7176,2
6265,T,7263,0,0,0,0,7262,7262,1
6266,A,7253,7242,0,1,0,0,7242,11
6266,C,7178,0,7178,0,0,0,7178,0
6267,A,7255,7255,0,0,0,0,7255,0
6267,G,7165,1,0,7081,0,2,7081,84
6268,A,7253,7253,0,0,0,0,7253,0
6268,G,7164,0,0,7163,0,1,7163,1
6269,G,7162,0,0,7161,0,1,7161,1
6269,T,7251,0,0,0,0,7250,7250,1
6270,C,7250,0,7250,0,0,0,7250,0
6270,G,7163,1,0,7162,0,0,7162,1
6271,A,7162,7158,0,4,0,0,7158,4
6271,A,7250,7233,0,0,0,0,7233,17
6272,A,7250,7250,0,0,0,0,7250,0
6272,G,7164,1,0,7163,0,0,7163,1
6273,A,7250,7249,0,1,0,0,7249,1
6273,T,7157,0,0,0,0,7157,7157,0
6274,A,7252,7249,0,1,0,0,7249,3
6274,C,7152,0,7152,0,0,0,7152,0
6275,A,7152,7150,0,1,0,1,7150,2
6275,G,7253,1,0,7252,0,0,7252,1
6276,A,7252,7245,0,1,0,0,7245,7
6276,G,7153,1,1,7150,0,0,7150,3
6277,A,7251,7251,0,0,0,0,7251,0
6277,G,7153,0,0,7153,0,0,7153,0
6278,C,7151,0,7151,0,0,0,7151,0
6278,T,7251,0,0,0,0,7251,7251,0
6279,A,7143,7139,0,0,0,0,7139,4
6279,A,7243,7243,0,0,0,0,7243,0
6280,A,7148,7147,1,0,0,0,7147,1
6280,G,7247,0,0,7247,0,0,7247,0
6281,A,7242,7242,0,0,0,0,7242,0
6281,C,7148,1,7144,0,0,2,7144,4
6282,C,7242,1,7236,0,0,1,7236,6
6282,T,7139,0,0,0,0,7139,7139,0
6283,A,7138,7138,0,0,0,0,7138,0
6283,C,7231,1,7229,1,0,0,7229,2
6284,G,7220,0,0,7220,0,0,7220,0
6284,T,7138,0,0,0,0,7138,7138,0
6285,A,7222,7222,0,0,0,0,7222,0
6285,G,7129,1,0,7125,0,0,7125,4
6286,G,7128,0,0,7128,0,0,7128,0
6286,G,7222,0,0,7222,0,0,7222,0
6287,A,7127,7125,0,1,0,0,7125,2
6287,A,7222,7221,0,1,0,0,7221,1
6288,T,7120,0,0,0,0,7120,7120,0
6288,T,7221,0,0,0,0,7221,7221,0
6289,A,7201,7200,0,0,0,1,7200,1
6289,G,7109,2,0,7107,0,0,7107,2
6290,A,7097,7097,0,0,0,0,7097,0
6290,G,7206,0,0,7194,0,0,7194,12
6291,A,7097,7095,0,2,0,0,7095,2
6291,G,7203,0,0,7203,0,0,7203,0
6292,C,7098,0,7098,0,0,0,7098,0
6292,G,7205,0,0,7204,0,1,7204,1
6293,G,7104,0,0,7104,0,0,7104,0
6293,T,7197,0,0,1,0,7191,7191,6
6294,A,7102,7097,0,0,0,0,7097,5
6294,T,7132,0,1,0,0,7131,7131,1
6295,A,7100,7100,0,0,0,0,7100,0
6295,G,7132,1,0,7131,0,0,7131,1
6296,A,7101,7100,0,1,0,0,7100,1
6296,A,7126,7126,0,0,0,0,7126,0
6297,G,7130,0,0,7129,0,0,7129,1
6297,T,7102,0,0,0,0,7102,7102,0
6298,A,7102,7101,0,0,0,0,7101,1
6298,T,7129,0,0,0,0,7129,7129,0
6299,G,7103,0,0,7103,0,0,7103,0
6299,G,7123,0,0,7123,0,0,7123,0
6300,A,7101,7100,0,1,0,0,7100,1
6300,T,7113,0,0,1,0,7110,7110,3
6301,C,7101,0,7099,0,0,0,7099,2
6301,T,7095,0,0,0,0,7095,7095,0
6302,A,7072,7071,0,0,0,0,7071,1
6302,G,7095,1,0,7093,0,0,7093,2
6303,G,7072,0,0,7071,0,0,7071,1
6303,T,7094,0,0,0,0,7093,7093,1
6304,A,7072,7072,0,0,0,0,7072,0
6304,T,7090,0,0,0,0,7090,7090,0
6305,C,7089,1,7082,0,0,0,7082,7
6305,T,7072,0,0,0,0,7072,7072,0
6306,C,7072,0,7071,0,0,1,7071,1
6306,C,7077,0,7077,0,0,0,7077,0
6307,A,7073,7073,0,0,0,0,7073,0
6307,G,7066,2,0,7064,0,0,7064,2
6308,C,7068,0,7068,0,0,0,7068,0
6308,G,7074,0,0,7073,0,1,7073,1
6309,T,7067,0,1,0,0,7066,7066,1
6309,T,7070,0,0,0,0,7053,7053,17
6310,G,7068,0,0,7068,0,0,7068,0
6310,T,7069,0,0,0,0,7069,7069,0
6311,A,7068,7068,0,0,0,0,7068,0
6311,T,7063,0,1,1,0,7061,7061,2
6312,G,7062,0,0,7058,0,2,7058,4
6312,G,7070,1,0,7069,0,0,7069,1
6313,A,7067,7067,0,0,0,0,7067,0
6313,G,7065,0,0,7065,0,0,7065,0
6314,A,7065,7063,0,0,0,0,7063,2
6314,T,7062,0,0,0,0,7062,7062,0
6315,A,7054,7054,0,0,0,0,7054,0
6315,A,7065,7065,0,0,0,0,7065,0
6316,C,7065,2,7062,0,0,0,7062,3
6316,G,7050,1,0,7047,0,1,7047,3
6317,A,7058,7056,0,0,0,0,7056,2
6317,G,7050,0,0,7050,0,0,7050,0
6318,A,7058,7057,1,0,0,0,7057,1
6318,T,7042,0,1,0,0,7041,7041,1
6319,G,7027,0,0,7027,0,0,7027,0
6319,G,7058,0,0,7058,0,0,7058,0
6320,A,7058,7058,0,0,0,0,7058,0
6320,C,7025,1,7022,0,0,0,7022,3
6321,C,7009,0,7009,0,0,0,7009,0
6321,G,7060,0,0,7060,0,0,7060,0
6322,T,7007,0,0,0,0,7007,7007,0
6322,T,7039,0,1,0,0,7038,7038,1
6323,C,7007,0,7007,0,0,0,7007,0
6323,C,7039,0,7029,0,0,1,7029,10
6324,A,7005,7005,0,0,0,0,7005,0
6324,C,7039,1,7038,0,0,0,7038,1
6325,A,7035,7034,0,0,0,0,7034,1
6325,C,7006,0,7003,0,0,2,7003,3
6326,C,7042,0,7041,0,0,1,7041,1
6326,T,6994,0,0,0,0,6994,6994,0
6327,G,7000,0,0,7000,0,0,7000,0
6327,T,7040,0,0,0,0,7040,7040,0
6328,A,6998,6998,0,0,0,0,6998,0
6328,A,7043,7043,0,0,0,0,7043,0
6329,T,6996,0,1,0,0,6993,6993,3
6329,T,7043,0,1,0,0,7037,7037,6
6330,T,6990,0,0,0,0,6990,6990,0
6330,T,7040,0,0,0,0,7040,7040,0
6331,A,6988,6988,0,0,0,0,6988,0
6331,A,7040,7036,0,0,0,0,7036,4
6332,A,6983,6982,0,1,0,0,6982,1
6332,A,7039,7039,0,0,0,0,7039,0
6333,A,7038,7036,1,0,0,0,7036,2
6333,G,6985,0,0,6985,0,0,6985,0
6334,C,6981,0,6979,0,0,1,6979,2
6334,G,7038,0,0,7038,0,0,7038,0
6335,A,6977,6972,0,0,0,0,6972,5
6335,A,6980,6979,1,0,0,0,6979,1
6336,A,6978,6978,0,0,0,0,6978,0
6336,T,6948,0,2,0,0,6942,6942,6
6337,C,6924,1,6923,0,0,0,6923,1
6337,T,6947,0,0,0,0,6947,6947,0
6338,G,6923,1,0,6920,0,0,6920,3
6338,G,6948,0,0,6944,0,0,6944,4
6339,G,6948,0,1,6947,0,0,6947,1
6339,T,6921,0,1,0,0,6920,6920,1
6340,G,6922,0,0,6918,0,0,6918,4
6340,T,6946,1,1,1,0,6943,6943,3
6341,A,6942,6937,0,0,0,1,6937,5
6341,G,6922,1,0,6921,0,0,6921,1
6342,A,6920,6920,0,0,0,0,6920,0
6342,A,6934,6933,1,0,0,0,6933,1
6343,C,6922,0,6921,0,0,1,6921,1
6343,C,6934,1,6927,0,0,1,6927,7
6344,C,6931,4,6926,0,0,1,6926,5
6344,T,6915,0,0,0,0,6915,6915,0
6345,C,6914,0,6912,0,0,0,6912,2
6345,G,6932,0,0,6932,0,0,6932,0
6346,A,6932,6931,0,1,0,0,6931,1
6346,C,6914,0,6910,0,0,2,6910,4
6347,A,6908,6901,0,1,0,0,6901,7
6347,T,6929,1,0,0,0,6925,6925,4
6348,A,6910,6910,0,0,0,0,6910,0
6348,T,6928,0,0,0,0,6928,6928,0
6349,C,6909,0,6909,0,0,0,6909,0
6349,C,6928,0,6927,0,0,0,6927,1
6350,G,6909,0,0,6909,0,0,6909,0
6350,T,6927,0,1,0,0,6926,6926,1
6351,A,6927,6926,0,1,0,0,6926,1
6351,T,6909,0,0,0,0,6909,6909,0
6352,C,6895,0,6895,0,0,0,6895,0
6352,G,6926,0,0,6919,0,0,6919,7
6353,A,6895,6888,0,0,0,0,6888,7
6353,G,6927,1,0,6926,0,0,6926,1
6354,A,6894,6892,1,1,0,0,6892,2
6354,T,6934,0,2,0,0,6932,6932,2
6355,A,6894,6892,0,2,0,0,6892,2
6355,G,6921,0,0,6921,0,0,6921,0
6356,C,6920,0,6919,0,0,0,6919,1
6356,G,6894,0,0,6872,0,1,6872,22
6357,A,6918,6916,0,0,0,1,6916,2
6357,G,6892,0,0,6892,0,0,6892,0
6358,G,6891,1,1,6889,0,0,6889,2
6358,T,6916,0,0,0,0,6916,6916,0
6359,C,6884,0,6882,1,0,1,6882,2
6359,T,6913,0,1,0,0,6912,6912,1
6360,G,6884,2,0,6882,0,0,6882,2
6360,G,6911,0,0,6909,0,1,6909,2
6361,A,6884,6808,0,1,0,0,6808,76
6361,G,6911,0,0,6910,0,1,6910,1
6362,A,6884,6884,0,0,0,0,6884,0
6362,C,6906,0,6905,0,0,1,6905,1
6363,A,6884,6884,0,0,0,0,6884,0
6363,G,6905,1,0,6904,0,0,6904,1
6364,A,6884,6884,0,0,0,0,6884,0
6364,C,6905,0,6905,0,0,0,6905,0
6365,A,6883,6882,0,0,0,0,6882,1
6365,A,6900,6899,0,0,0,1,6899,1
6366,C,6884,2,6874,0,0,0,6874,10
6366,G,6900,1,0,6899,0,0,6899,1
6367,A,6900,6730,0,0,0,0,6730,170
6367,C,6881,0,6880,0,0,1,6880,1
6368,A,6900,6899,1,0,0,0,6899,1
6368,G,6882,0,0,6882,0,0,6882,0
6369,A,6900,6900,0,0,0,0,6900,0
6369,T,6881,0,0,0,0,6881,6881,0
6370,A,6898,6896,1,0,0,1,6896,2
6370,C,6881,0,6881,0,0,0,6881,0
6371,A,6898,6898,0,0,0,0,6898,0
6371,T,6881,0,1,0,0,6880,6880,1
6372,A,6882,6879,0,0,0,2,6879,3
6372,A,6898,6898,0,0,0,0,6898,0
6373,A,6899,6898,0,0,0,1,6898,1
6373,T,6882,1,0,1,0,6880,6880,2
6374,C,6882,0,6881,0,0,1,6881,1
6374,T,6898,0,0,1,0,6897,6897,1
6375,A,6866,6865,0,1,0,0,6865,1
6375,G,6900,2,0,6898,0,0,6898,2
6376,C,6896,0,6883,0,0,0,6883,13
6376,G,6866,0,0,6851,0,0,6851,15
6377,C,6896,0,6896,0,0,0,6896,0
6377,G,6861,0,0,6861,0,0,6861,0
6378,G,6862,0,0,6862,0,0,6862,0
6378,T,6896,0,0,0,0,6896,6896,0
6379,C,6855,0,6855,0,0,0,6855,0
6379,G,6896,0,0,6896,0,0,6896,0
6380,A,6897,6897,0,0,0,0,6897,0
6380,G,6853,3,0,6850,0,0,6850,3
6381,A,6847,6847,0,0,0,0,6847,0
6381,T,6897,0,2,2,0,6892,6892,5
6382,G,6897,0,0,6897,0,0,6897,0
6382,T,6847,0,0,0,0,6846,6846,1
6383,C,6894,2,6888,0,0,3,6888,6
6383,G,6849,1,0,6846,0,1,6846,3
6384,G,6851,3,0,6848,0,0,6848,3
6384,G,6892,0,0,6892,0,0,6892,0
6385,A,6893,6893,0,0,0,0,6893,0
6385,C,6848,0,6837,1,0,1,6837,11
6386,C,6844,0,6844,0,0,0,6844,0
6386,C,6892,0,6890,0,0,1,6890,2
6387,C,6842,0,6842,0,0,0,6842,0
6387,G,6890,0,0,6890,0,0,6890,0
6388,A,6840,6840,0,0,0,0,6840,0
6388,C,6893,0,6893,0,0,0,6893,0
6389,C,6841,0,6840,0,0,0,6840,1
6389,T,6882,1,1,1,0,6879,6879,3
6390,G,6883,1,0,6882,0,0,6882,1
6390,T,6833,1,0,0,0,6832,6832,1
6391,A,6835,6835,0,0,0,0,6835,0
6391,C,6883,0,6882,0,0,0,6882,1
6392,C,6826,0,6826,0,0,0,6826,0
6392,G,6882,1,0,6880,0,0,6880,2
6393,C,6883,0,6882,0,0,0,6882,1
6393,G,6812,4,0,6808,0,0,6808,4
6394,G,6884,0,0,6884,0,0,6884,0
6394,T,6799,0,0,0,0,6799,6799,0
6395,G,6794,0,0,6794,0,0,6794,0
6395,T,6887,0,1,0,0,6885,6885,2
6396,A,6794,6793,0,0,0,0,6793,1
6396,C,6886,0,6886,0,0,0,6886,0
6397,A,6793,6791,1,1,0,0,6791,2
6397,T,6880,2,0,1,0,6876,6876,4
6398,C,6780,0,6776,0,0,0,6776,4
6398,T,6880,0,0,0,0,6880,6880,0
6399,A,6876,6874,0,2,0,0,6874,2
6399,C,6766,1,6765,0,0,0,6765,1
6400,A,6756,6753,1,0,0,1,6753,3
6400,T,6877,0,1,0,0,6876,6876,1
6401,A,6874,6874,0,0,0,0,6874,0
6401,T,6754,0,0,0,0,6754,6754,0
6402,C,6753,0,6753,0,0,0,6753,0
6402,C,6874,0,6873,0,0,0,6873,1
6403,A,6754,6754,0,0,0,0,6754,0
6403,T,6824,0,1,0,0,6823,6823,1
6404,C,6755,0,6747,0,0,0,6747,8
6404,C,6815,0,6785,0,0,2,6785,30
6405,C,6751,1,6750,0,0,0,6750,1
6405,C,6809,0,6809,0,0,0,6809,0
6406,C,6749,0,6749,0,0,0,6749,0
6406,C,6801,1,6800,0,0,0,6800,1
6407,A,6801,6801,0,0,0,0,6801,0
6407,T,6728,1,0,0,0,6727,6727,1
6408,A,6729,6726,0,0,0,0,6726,3
6408,C,6797,0,6796,0,0,0,6796,1
6409,A,6729,6729,0,0,0,0,6729,0
6409,A,6793,6791,0,2,0,0,6791,2
6410,T,6728,0,0,0,0,6728,6728,0
6410,T,6789,0,0,0,0,6789,6789,0
6411,A,6760,6760,0,0,0,0,6760,0
6411,C,6728,0,6727,0,0,1,6727,1
6412,A,6723,6719,1,0,0,0,6719,4
6412,T,6761,0,1,0,0,6760,6760,1
6413,A,6715,6713,0,0,0,2,6713,2
6413,G,6750,0,0,6749,0,0,6749,1
6414,C,6750,0,6746,0,0,0,6746,4
6414,G,6715,0,0,6715,0,0,6715,0
6415,C,6747,0,6746,0,0,1,6746,1
6415,T,6713,1,0,0,0,6587,6587,126
6416,A,6728,6727,0,1,0,0,6727,1
6416,T,6707,0,0,0,0,6707,6707,0
6417,G,6728,0,0,6728,0,0,6728,0
6417,T,6706,0,0,1,0,6705,6705,1
6418,A,6728,6728,0,0,0,0,6728,0
6418,T,6706,1,0,0,0,6705,6705,1
6419,T,6706,0,0,0,0,6706,6706,0
6419,T,6727,0,0,0,0,6726,6726,1
6420,T,6706,0,1,4,0,6696,6696,10
6420,T,6722,0,1,0,0,6721,6721,1
6421,C,6719,0,6717,0,0,1,6717,2
6421,G,6701,0,0,6636,0,3,6636,65
6422,A,6715,6715,0,0,0,0,6715,0
6422,G,6706,0,0,6705,0,1,6705,1
6423,G,6703,0,0,6702,0,1,6702,1
6423,G,6715,0,0,6715,0,0,6715,0
6424,C,6716,0,6714,1,0,1,6714,2
6424,G,6703,0,0,6703,0,0,6703,0
6425,A,6713,6711,1,0,0,0,6711,2
6425,T,6702,0,0,0,0,6701,6701,1
6426,A,6713,6713,0,0,0,0,6713,0
6426,C,6702,1,6701,0,0,0,6701,1
6427,C,6707,0,6707,0,0,0,6707,0
6427,G,6702,1,0,6700,0,1,6700,2
6428,A,6703,6703,0,0,0,0,6703,0
6428,G,6708,0,0,6706,0,0,6706,2
6429,G,6703,0,0,6696,0,1,6696,7
6429,G,6708,1,0,6707,0,0,6707,1
6430,A,6707,6707,0,0,0,0,6707,0
6430,G,6703,0,0,6702,0,0,6702,1
6431,T,6701,0,1,0,0,6700,6700,1
6431,T,6707,0,0,0,0,6707,6707,0
6432,A,6705,6705,0,0,0,0,6705,0
6432,G,6703,0,0,6703,0,0,6703,0
6433,C,6701,0,6699,0,0,2,6699,2
6433,C,6704,0,6701,0,0,3,6701,3
6434,C,6701,1,6700,0,0,0,6700,1
6434,G,6702,0,0,6699,0,1,6699,3
6435,G,6701,1,0,6700,0,0,6700,1
6435,G,6702,0,1,6701,0,0,6701,1
6436,C,6698,0,6698,0,0,0,6698,0
6436,T,6700,0,0,0,0,6700,6700,0
6437,A,6700,6698,0,0,0,0,6698,2
6437,T,6658,0,1,0,0,6654,6654,4
6438,A,6700,6698,0,1,0,0,6698,2
6438,T,6649,0,3,0,0,6645,6645,4
6439,A,6691,6691,0,0,0,0,6691,0
6439,C,6649,0,6604,0,0,1,6604,45
6440,C,6649,0,6648,0,0,1,6648,1
6440,G,6692,0,0,6692,0,0,6692,0
6441,C,6649,1,6648,0,0,0,6648,1
6441,C,6690,0,6689,0,0,1,6689,1
6442,A,6684,6683,0,0,0,0,6683,1
6442,C,6645,0,6644,0,0,0,6644,1
6443,A,6637,6634,1,1,0,0,6634,3
6443,C,6684,0,6684,0,0,0,6684,0
6444,A,6638,6638,0,0,0,0,6638,0
6444,T,6681,0,0,0,0,6681,6681,0
6445,A,6681,6671,0,0,0,0,6671,10
6445,C,6638,0,6638,0,0,0,6638,0
6446,A,6681,6680,0,0,0,1,6680,1
6446,T,6633,1,0,0,0,6630,6630,3
6447,A,6681,6679,0,0,0,2,6679,2
6447,T,6623,0,0,1,0,6621,6621,2
6448,G,6623,0,0,6622,0,1,6622,1
6448,T,6682,0,0,0,0,6682,6682,0
6449,C,6623,0,6611,1,0,1,6611,12
6449,C,6663,0,6662,0,0,1,6662,1
6450,C,6622,0,6622,0,0,0,6622,0
6450,G,6662,2,0,6659,0,0,6659,3
6451,C,6622,0,6622,0,0,0,6622,0
6451,G,6662,1,0,6661,0,0,6661,1
6452,A,6621,6621,0,0,0,0,6621,0
6452,A,6661,6656,0,1,0,1,6656,5
6453,A,6661,6661,0,0,0,0,6661,0
6453,C,6626,0,6625,0,0,1,6625,1
6454,C,6663,0,6645,0,0,0,6645,18
6454,T,6627,0,0,0,0,6627,6627,0
6455,C,6660,1,6658,0,0,1,6658,2
6455,T,6627,1,1,0,0,6625,6625,2
6456,C,6628,1,6623,0,0,0,6623,5
6456,C,6660,0,6659,0,0,1,6659,1
6457,C,6612,0,6612,0,0,0,6612,0
6457,T,6659,1,0,0,0,6658,6658,1
6458,A,6612,6609,1,1,0,0,6609,3
6458,A,6659,6649,0,0,0,0,6649,10
6459,A,6659,6659,0,0,0,0,6659,0
6459,T,6612,0,0,0,0,6612,6612,0
6460,A,6611,6611,0,0,0,0,6611,0
6460,A,6659,6658,0,1,0,0,6658,1
6461,C,6611,2,6608,0,0,1,6608,3
6461,G,6659,0,0,6626,0,0,6626,33
6462,G,6538,3,0,6535,0,0,6535,3
6462,G,6636,0,0,6635,0,1,6635,1
6463,G,6621,0,0,6621,0,0,6621,0
6463,T,6525,0,0,0,0,6525,6525,0
6464,A,6549,6548,0,0,0,0,6548,1
6464,G,6525,0,0,6524,0,0,6524,1
6465,G,6549,0,3,6545,0,0,6545,4
6465,T,6511,0,0,0,0,6511,6511,0
6466,C,6510,0,6503,0,0,2,6503,7
6466,C,6549,0,6441,0,0,2,6441,108
6467,C,6511,0,6509,0,0,1,6509,2
6467,C,6547,0,6547,0,0,0,6547,0
6468,C,6548,0,6548,0,0,0,6548,0
6468,T,6507,0,1,0,0,6505,6505,2
6469,C,6508,0,6504,0,0,0,6504,4
6469,C,6547,0,6547,0,0,0,6547,0
6470,C,6499,0,6499,0,0,0,6499,0
6470,C,6545,0,6545,0,0,0,6545,0
6471,G,6544,0,0,6544,0,0,6544,0
6471,T,6493,0,0,0,0,6493,6493,0
6472,A,6544,6542,0,1,0,1,6542,2
6472,T,6493,0,0,0,0,6493,6493,0
6473,A,6488,6488,0,0,0,0,6488,0
6473,T,6544,1,0,0,0,6532,6532,12
6474,C,6490,0,6488,0,0,0,6488,2
6474,T,6543,0,0,0,0,6543,6543,0
6475,C,6489,0,6489,0,0,0,6489,0
6475,T,6543,0,0,0,0,6543,6543,0
6476,A,6481,6481,0,0,0,0,6481,0
6476,A,6542,6542,0,0,0,0,6542,0
6477,G,6481,0,0,6481,0,0,6481,0
6477,G,6542,1,0,6541,0,0,6541,1
6478,A,6475,6464,0,0,0,0,6464,11
6478,A,6537,6537,0,0,0,0,6537,0
6479,A,6476,6476,0,0,0,0,6476,0
6479,G,6538,0,0,6538,0,0,6538,0
6480,A,6476,6475,0,0,0,1,6475,1
6480,C,6532,0,6531,0,0,1,6531,1
6481,T,6475,1,0,1,0,6464,6464,11
6481,T,6502,0,0,0,0,6501,6501,1
6482,T,6471,0,0,0,0,6471,6471,0
6482,T,6501,0,2,0,0,6499,6499,2
6483,G,6501,0,0,6501,0,0,6501,0
6483,T,6469,0,1,0,0,6468,6468,1
6484,A,6470,6470,0,0,0,0,6470,0
6484,A,6501,6501,0,0,0,0,6501,0
6485,C,6501,0,6501,0,0,0,6501,0
6485,T,6471,0,0,0,0,6471,6471,0
6486,C,6471,0,6466,0,0,0,6466,5
6486,G,6500,2,1,6413,0,0,6413,87
6487,C,6469,0,6469,0,0,0,6469,0
6487,G,6500,1,0,6499,0,0,6499,1
6488,G,6499,2,0,6496,0,1,6496,3
6488,T,6459,0,0,1,0,6458,6458,1
6489,G,6497,1,0,6495,0,0,6495,2
6489,T,6459,0,0,0,0,6459,6459,0
6490,A,6458,6453,0,0,0,0,6453,5
6490,A,6496,6480,1,8,0,0,6480,16
6491,A,6458,6458,0,0,0,0,6458,0
6491,A,6496,6495,0,1,0,0,6495,1
6492,A,6495,6493,0,1,0,1,6493,2
6492,G,6458,0,0,6457,0,1,6457,1
6493,A,6453,6435,18,0,0,0,6435,18
6493,G,6495,1,0,6494,0,0,6494,1
6494,C,6495,0,6487,0,0,1,6487,8
6494,T,6453,0,1,0,0,6452,6452,1
6495,C,6449,0,6429,0,0,0,6429,20
6495,C,6494,0,6494,0,0,0,6494,0
6496,C,6449,0,6447,0,0,2,6447,2
6496,G,6493,0,0,6486,0,0,6486,7
6497,C,6430,1,6428,0,0,1,6428,2
6497,G,6493,0,0,6493,0,0,6493,0
6498,C,6493,0,6491,0,0,1,6491,2
6498,G,6430,0,0,6430,0,0,6430,0
6499,A,6430,6425,0,0,0,0,6425,5
6499,G,6492,0,0,6492,0,0,6492,0
6500,A,6430,6428,0,0,0,2,6428,2
6500,A,6492,6490,0,0,0,0,6490,2
6501,A,6493,6492,0,0,0,1,6492,1
6501,T,6430,0,0,0,0,6430,6430,0
6502,C,6416,0,6416,0,0,0,6416,0
6502,C,6493,0,6492,0,0,0,6492,1
6503,G,6419,1,0,6418,0,0,6418,1
6503,G,6490,0,0,6489,0,0,6489,1
6504,T,6418,0,0,0,0,6396,6396,22
6504,T,6490,0,1,0,0,6489,6489,1
6505,G,6490,0,0,6487,0,0,6487,3
6505,T,6418,0,0,0,0,6418,6418,0
6506,G,6490,0,0,6490,0,0,6490,0
6506,T,6418,2,0,0,0,6416,6416,2
6507,A,6417,6403,0,1,0,1,6403,14
6507,C,6490,0,6488,0,0,1,6488,2
6508,A,6417,6417,0,0,0,0,6417,0
6508,G,6490,1,0,6489,0,0,6489,1
6509,A,6418,6418,0,0,0,0,6418,0
6509,A,6490,6490,0,0,0,0,6490,0
6510,C,6417,1,6414,0,0,2,6414,3
6510,G,6490,0,0,6490,0,0,6490,0
6511,A,6490,6481,0,1,0,0,6481,9
6511,T,6415,0,0,0,0,6414,6414,1
6512,A,6490,6490,0,0,0,0,6490,0
6512,C,6395,1,6394,0,0,0,6394,1
6513,A,6490,6489,0,1,0,0,6489,1
6513,G,6393,0,0,6392,0,0,6392,1
6514,A,6394,6393,0,1,0,0,6393,1
6514,G,6490,1,0,6488,0,0,6488,2
6515,C,6394,0,6394,0,0,0,6394,0
6515,G,6490,0,0,6490,0,0,6490,0
6516,A,6486,6482,0,0,0,0,6482,4
6516,T,6392,0,0,0,0,6392,6392,0
6517,A,6485,6484,0,0,0,0,6484,1
6517,C,6392,0,6392,0,0,0,6392,0
6518,G,6484,0,0,6443,0,0,6443,41
6518,T,6388,0,0,0,0,6388,6388,0
6519,G,6387,1,0,6382,0,0,6382,5
6519,G,6482,0,0,6482,0,0,6482,0
6520,G,6387,1,0,6386,0,0,6386,1
6520,G,6481,0,0,6481,0,0,6481,0
6521,A,6478,6475,0,2,0,0,6475,3
6521,C,6386,0,6385,0,0,1,6385,1
6522,A,6478,6477,0,0,0,0,6477,1
6522,T,6383,0,1,0,0,6380,6380,3
6523,C,6356,0,6355,0,0,1,6355,1
6523,G,6477,0,0,6477,0,0,6477,0
6524,A,6473,6462,0,0,0,0,6462,11
6524,T,6355,0,0,0,0,6355,6355,0
6525,A,6356,6355,0,1,0,0,6355,1
6525,A,6473,6473,0,0,0,0,6473,0
6526,A,6471,6470,0,0,0,1,6470,1
6526,T,6357,0,0,0,0,6357,6357,0
6527,C,6357,0,6355,0,0,2,6355,2
6527,G,6471,0,0,6471,0,0,6471,0
6528,C,6466,0,6466,0,0,0,6466,0
6528,G,6351,0,0,6351,0,0,6351,0
6529,A,6343,6342,0,0,0,0,6342,1
6529,G,6462,0,0,6462,0,0,6462,0
6530,A,6343,6343,0,0,0,0,6343,0
6530,A,6462,6454,0,2,0,0,6454,8
6531,A,6462,6461,0,1,0,0,6461,1
6531,T,6343,0,0,0,0,6343,6343,0
6532,A,6461,6460,0,1,0,0,6460,1
6532,C,6340,0,6340,0,0,0,6340,0
6533,G,6461,0,0,6458,0,0,6458,3
6533,T,6339,0,0,0,0,6339,6339,0
6534,C,6330,0,6328,0,0,0,6328,2
6534,G,6461,0,0,6461,0,0,6461,0
6535,A,6446,6444,1,1,0,0,6444,2
6535,C,6330,0,6330,0,0,0,6330,0
6536,G,6329,0,0,6328,0,1,6328,1
6536,G,6446,0,0,6445,0,0,6445,1
6537,C,6445,0,6441,3,0,0,6441,4
6537,T,6329,0,0,0,0,6329,6329,0
6538,C,6326,0,6326,0,0,0,6326,0
6538,G,6445,0,0,6431,0,1,6431,14
6539,G,6326,1,0,6325,0,0,6325,1
6539,G,6445,0,0,6445,0,0,6445,0
6540,G,6445,0,0,6445,0,0,6445,0
6540,T,6326,0,0,0,0,6318,6318,8
6541,C,6445,0,6445,0,0,0,6445,0
6541,T,6324,0,0,0,0,6324,6324,0
6542,G,6441,1,0,6439,0,0,6439,2
6542,T,6324,0,0,0,0,6324,6324,0
6543,C,6319,0,6319,0,0,0,6319,0
6543,C,6439,0,6439,0,0,0,6439,0
6544,G,6318,0,0,6317,0,1,6317,1
6544,T,6439,1,0,1,0,6437,6437,2
6545,A,6318,6318,0,0,0,0,6318,0
6545,A,6439,6437,0,1,0,0,6437,2
6546,G,6318,0,0,6318,0,0,6318,0
6546,G,6439,1,0,6428,0,2,6428,11
6547,C,6318,0,6318,0,0,0,6318,0
6547,G,6437,1,0,6436,0,0,6436,1
6548,G,6437,0,0,6436,0,0,6436,1
6548,T,6317,0,0,0,0,6315,6315,2
6549,C,6424,0,6422,0,0,2,6422,2
6549,T,6317,0,0,0,0,6317,6317,0
6550,A,6317,6315,0,2,0,0,6315,2
6550,G,6416,1,0,6413,0,0,6413,3
6551,C,6316,0,6312,0,0,4,6312,4
6551,C,6415,0,6415,0,0,0,6415,0
6552,G,6316,0,1,6314,0,1,6314,2
6552,T,6410,0,0,1,0,6409,6409,1
6553,C,6314,0,6313,0,0,0,6313,1
6553,G,6410,1,0,6405,0,1,6405,5
6554,G,6313,0,0,6313,0,0,6313,0
6554,G,6410,0,0,6410,0,0,6410,0
6555,A,6311,6308,0,0,0,0,6308,3
6555,C,6410,0,6407,0,0,1,6407,3
6556,A,6310,6308,1,1,0,0,6308,2
6556,A,6409,6403,0,1,0,0,6403,6
6557,A,6403,6403,0,0,0,0,6403,0
6557,C,6310,1,6308,0,0,1,6308,2
6558,A,6305,6304,1,0,0,0,6304,1
6558,G,6403,0,0,6403,0,0,6403,0
6559,G,6305,1,0,6304,0,0,6304,1
6559,T,6401,1,0,0,0,6400,6400,1
6560,C,6302,0,6302,0,0,0,6302,0
6560,G,6398,0,0,6398,0,0,6398,0
6561,C,6302,1,6301,0,0,0,6301,1
6561,T,6398,0,0,0,0,6397,6397,1
6562,A,6385,6385,0,0,0,0,6385,0
6562,G,6301,2,0,6298,0,0,6298,3
6563,G,6385,0,0,6385,0,0,6385,0
6563,T,6298,0,0,0,0,6297,6297,1
6564,C,6375,0,6373,1,0,1,6373,2
6564,G,6299,0,0,6295,0,0,6295,4
6565,G,6299,1,0,6297,0,1,6297,2
6565,G,6375,0,1,6372,0,0,6372,3
6566,C,6296,0,6293,0,0,1,6293,3
6566,G,6374,0,0,6373,0,1,6373,1
6567,G,6296,1,0,6294,0,0,6294,2
6567,T,6334,0,0,0,0,6334,6334,0
6568,C,6283,0,6282,0,0,1,6282,1
6568,C,6333,0,6331,0,0,2,6331,2
6569,A,6331,6331,0,0,0,0,6331,0
6569,T,6280,0,0,0,0,6280,6280,0
6570,C,6280,1,6279,0,0,0,6279,1
6570,C,6331,0,6331,0,0,0,6331,0
6571,A,6280,6279,0,1,0,0,6279,1
6571,G,6331,0,0,6331,0,0,6331,0
6572,C,6331,0,6331,0,0,0,6331,0
6572,T,6280,0,1,0,0,6265,6265,15
6573,T,6279,2,0,0,0,6277,6277,2
6573,T,6323,0,0,0,0,6323,6323,0
6574,G,6323,2,0,6321,0,0,6321,2
6574,T,6274,0,0,0,0,6274,6274,0
6575,C,6311,0,6309,0,0,1,6309,2
6575,G,6274,1,0,6273,0,0,6273,1
6576,C,6274,0,6272,0,0,2,6272,2
6576,G,6311,0,0,6311,0,0,6311,0
6577,C,6311,0,6308,0,0,3,6308,3
6577,T,6274,0,1,0,0,6273,6273,1
6578,C,6274,0,6273,0,0,1,6273,1
6578,G,6311,0,0,6311,0,0,6311,0
6579,G,6257,2,0,6255,0,0,6255,2
6579,T,6308,0,0,0,0,6306,6306,2
6580,A,6308,6304,0,0,0,0,6304,4
6580,T,6257,0,0,0,0,6256,6256,1
6581,A,6307,6306,1,0,0,0,6306,1
6581,C,6256,0,6256,0,0,0,6256,0
6582,C,6307,0,6302,0,0,0,6302,5
6582,G,6256,1,0,6229,0,0,6229,27
6583,C,6295,0,6294,0,0,0,6294,1
6583,G,6257,2,0,6255,0,0,6255,2
6584,A,6289,6288,1,0,0,0,6288,1
6584,G,6257,3,0,6254,0,0,6254,3
6585,C,6257,0,6257,0,0,0,6257,0
6585,C,6290,0,6286,0,0,0,6286,4
6586,A,6258,6258,0,0,0,0,6258,0
6586,C,6286,1,6285,0,0,0,6285,1
6587,A,6286,6283,1,2,0,0,6283,3
6587,T,6257,0,0,0,0,6257,6257,0
6588,C,6255,0,6254,0,0,1,6254,1
6588,C,6284,1,6282,0,0,1,6282,2
6589,A,6281,6278,2,0,0,0,6278,3
6589,G,6254,2,0,6252,0,0,6252,2
6590,A,6253,6245,0,1,0,0,6245,8
6590,C,6281,0,6264,0,0,1,6264,17
6591,A,6253,6253,0,0,0,0,6253,0
6591,C,6272,0,6269,0,0,3,6269,3
6592,C,6266,0,6266,0,0,0,6266,0
6592,T,6252,0,0,0,0,6251,6251,1
6593,C,6251,0,6249,0,0,1,6249,2
6593,G,6261,0,0,6261,0,0,6261,0
6594,C,6260,0,6257,0,0,0,6257,3
6594,T,6252,0,2,0,0,6250,6250,2
6595,C,6252,1,6251,0,0,0,6251,1
6595,C,6257,0,6255,0,0,0,6255,2
6596,G,6252,0,0,6252,0,0,6252,0
6596,G,6255,0,0,6252,0,3,6252,3
6597,C,6251,0,6250,0,0,0,6250,1
6597,T,6252,0,0,0,0,6251,6251,1
6598,C,6252,0,6251,0,0,1,6251,1
6598,G,6251,0,0,6251,0,0,6251,0
6599,A,6246,6246,0,0,0,0,6246,0
6599,C,6250,0,6250,0,0,0,6250,0
6600,G,6246,2,0,6244,0,0,6244,2
6600,T,6248,0,0,0,0,6247,6247,1
6601,C,6244,0,6242,0,0,2,6242,2
6601,T,6247,0,0,0,0,6247,6247,0
6602,A,6246,6244,0,0,0,0,6244,2
6602,T,6239,0,0,0,0,6239,6239,0
6603,A,6238,6238,0,0,0,0,6238,0
6603,A,6245,6244,1,0,0,0,6244,1
6604,T,6234,0,0,0,0,6232,6232,2
6604,T,6245,0,0,0,0,6245,6245,0
6605,C,6230,0,6228,0,0,0,6228,2
6605,G,6244,0,0,6244,0,0,6244,0
6606,C,6216,0,6214,0,0,2,6214,2
6606,G,6229,0,0,6229,0,0,6229,0
6607,G,6204,0,0,6204,0,0,6204,0
6607,T,6230,0,0,0,0,6230,6230,0
6608,C,6204,0,6199,0,0,0,6199,5
6608,C,6230,0,6229,0,0,1,6229,1
6609,A,6219,6216,0,3,0,0,6216,3
6609,C,6203,0,6201,1,0,1,6201,2
6610,G,6203,0,1,6202,0,0,6202,1
6610,G,6219,0,0,6218,0,1,6218,1
6611,C,6203,0,6202,0,0,0,6202,1
6611,C,6219,0,6219,0,0,0,6219,0
6612,T,6203,0,1,0,0,6202,6202,1
6612,T,6208,1,0,0,0,6202,6202,6
6613,A,6203,6202,0,1,0,0,6202,1
6613,T,6208,0,0,0,0,6208,6208,0
6614,A,6206,6204,1,0,0,0,6204,2
6614,C,6203,0,6201,0,0,2,6201,2
6615,A,6197,6196,1,0,0,0,6196,1
6615,C,6206,1,6202,0,0,0,6202,4
6616,C,6205,0,6203,0,0,1,6203,2
6616,G,6197,1,0,6170,0,1,6170,27
6617,G,6168,0,0,6168,0,0,6168,0
6617,T,6201,0,0,0,0,6122,6122,79
6618,G,6168,2,1,6164,0,0,6164,4
6618,T,6199,0,0,1,0,6198,6198,1
6619,C,6113,0,6108,1,0,2,6108,5
6619,T,6193,1,0,0,0,6192,6192,1
6620,G,6109,0,0,6108,0,0,6108,1
6620,T,6193,0,0,0,0,6193,6193,0
6621,C,6108,0,6107,0,0,1,6107,1
6621,T,6193,0,0,0,0,6193,6193,0
6622,G,6106,0,0,6106,0,0,6106,0
6622,G,6193,0,0,6182,0,0,6182,11
6623,G,6192,2,0,6190,0,0,6190,2
6623,T,6105,0,1,0,0,6103,6103,2
6624,C,6192,0,6191,0,0,1,6191,1
6624,G,6105,0,0,6064,0,0,6064,41
6625,A,6182,6182,0,0,0,0,6182,0
6625,G,6101,0,0,6101,0,0,6101,0
6626,G,6100,0,0,6100,0,0,6100,0
6626,G,6182,0,0,6182,0,0,6182,0
6627,C,6180,0,6179,0,0,1,6179,1
6627,G,6096,0,0,6095,0,1,6095,1
6628,A,6093,6089,0,3,0,0,6089,4
6628,G,6180,0,0,6180,0,0,6180,0
6629,A,6180,6180,0,0,0,0,6180,0
6629,T,6087,0,0,1,0,6086,6086,1
6630,A,6079,6077,0,1,0,0,6077,2
6630,T,6180,0,0,0,0,6180,6180,0
6631,C,6079,0,5960,0,0,1,5960,119
6631,C,6180,0,6178,0,0,2,6178,2
6632,C,6077,0,6077,0,0,0,6077,0
6632,G,6180,0,0,6180,0,0,6180,0
6633,C,6076,0,6076,0,0,0,6076,0
6633,C,6180,0,6178,0,0,2,6178,2
6634,C,6067,0,6067,0,0,0,6067,0
6634,G,6180,0,0,6178,0,0,6178,2
6635,C,6064,0,6064,0,0,0,6064,0
6635,G,6179,2,0,6177,0,0,6177,2
6636,C,6177,0,6176,0,0,0,6176,1
6636,T,6062,0,0,0,0,6062,6062,0
6637,A,6060,6060,0,0,0,0,6060,0
6637,T,6175,0,0,0,0,6175,6175,0
6638,C,6174,0,6158,0,0,0,6158,16
6638,G,6060,0,0,6058,0,1,6058,2
6639,A,6029,6029,0,0,0,0,6029,0
6639,C,6172,0,6172,0,0,0,6172,0
6640,C,6172,0,6168,0,0,3,6168,4
6640,G,6019,0,0,6018,0,0,6018,1
6641,C,5999,0,5973,0,0,0,5973,26
6641,G,6171,0,0,6171,0,0,6171,0
6642,A,6171,6170,0,1,0,0,6170,1
6642,C,5945,1,5944,0,0,0,5944,1
6643,C,5940,0,5940,0,0,0,5940,0
6643,C,6171,0,6170,0,0,0,6170,1
6644,A,6166,6166,0,0,0,0,6166,0
6644,C,5931,0,5931,0,0,0,5931,0
6645,A,5927,5927,0,0,0,0,5927,0
6645,T,6166,0,0,0,0,6165,6165,1
6646,C,6165,0,6165,0,0,0,6165,0
6646,G,5927,0,0,5927,0,0,5927,0
6647,C,5927,0,5926,0,0,1,5926,1
6647,T,6156,1,1,0,0,6154,6154,2
6648,T,5925,0,0,0,0,5924,5924,1
6648,T,6155,0,2,1,0,6152,6152,3
6649,G,5916,1,0,5908,0,0,5908,8
6649,G,6155,0,0,6152,0,0,6152,3
6650,G,5915,0,0,5915,0,0,5915,0
6650,G,6155,0,0,6155,0,0,6155,0
6651,A,6155,6154,0,0,0,0,6154,1
6651,T,5915,0,0,0,0,5911,5911,4
6652,C,6155,1,6151,0,0,1,6151,4
6652,T,5915,0,0,0,0,5915,5915,0
6653,C,5915,0,5914,0,0,0,5914,1
6653,C,6133,0,6133,0,0,0,6133,0
6654,A,6128,6128,0,0,0,0,6128,0
6654,T,5899,0,0,0,0,5894,5894,5
6655,T,5899,0,0,1,0,5898,5898,1
6655,T,6127,0,0,0,0,6125,6125,2
6656,T,5899,0,2,0,0,5896,5896,3
6656,T,6127,0,0,0,0,6127,6127,0
6657,A,6126,6126,0,0,0,0,6126,0
6657,C,5898,0,5890,0,0,0,5890,8
6658,C,5891,1,5888,0,0,1,5888,3
6658,G,6126,0,0,6126,0,0,6126,0
6659,C,6125,0,6125,0,0,0,6125,0
6659,G,5887,1,1,5885,0,0,5885,2
6660,C,5888,1,5877,0,0,1,5877,11
6660,T,6123,0,0,0,0,6123,6123,0
6661,C,5887,0,5887,0,0,0,5887,0
6661,C,6118,0,6111,0,0,1,6111,7
6662,C,6112,0,6111,0,0,1,6111,1
6662,T,5886,0,0,0,0,5886,5886,0
6663,A,6109,6107,0,1,0,0,6107,2
6663,C,5886,0,5886,0,0,0,5886,0
6664,A,5885,5884,0,1,0,0,5884,1
6664,C,6109,0,6108,0,0,0,6108,1
6665,A,6109,6109,0,0,0,0,6109,0
6665,G,5885,1,0,5884,0,0,5884,1
6666,A,5885,5883,0,0,0,0,5883,2
6666,G,6109,0,0,6106,0,0,6106,3
6667,A,5885,5885,0,0,0,0,5885,0
6667,G,6101,0,0,6101,0,0,6101,0
6668,G,5885,0,0,5885,0,0,5885,0
6668,T,6081,0,0,0,0,6081,6081,0
6669,A,6080,6079,0,0,0,0,6079,1
6669,C,5880,0,5877,0,0,0,5877,3
6670,C,5878,0,5878,0,0,0,5878,0
6670,T,6071,0,0,0,0,6067,6067,4
6671,A,5874,5873,0,0,0,0,5873,1
6671,C,6068,0,6068,0,0,0,6068,0
6672,T,5874,0,0,0,0,5873,5873,1
6672,T,6066,0,0,0,0,6064,6064,2
6673,A,5874,5871,0,1,0,1,5871,3
6673,T,6053,0,0,0,0,6051,6051,2
6674,C,6050,0,6049,0,0,1,6049,1
6674,G,5873,0,0,5873,0,0,5873,0
6675,A,5853,5851,0,2,0,0,5851,2
6675,T,6026,0,1,0,0,6022,6022,4
6676,G,5853,0,0,5851,0,1,5851,2
6676,T,6026,0,4,0,0,6022,6022,4
6677,C,5841,0,5830,0,0,1,5830,11
6677,C,6026,0,5964,0,0,0,5964,62
6678,C,5809,0,5809,0,0,0,5809,0
6678,C,6018,0,6018,0,0,0,6018,0
6679,C,5809,1,5808,0,0,0,5808,1
6679,C,6017,0,6016,0,0,1,6016,1
6680,A,5804,5804,0,0,0,0,5804,0
6680,T,5996,0,0,0,0,5994,5994,2
6681,C,5804,0,5802,0,0,1,5802,2
6681,C,5994,0,5991,0,0,0,5991,3
6682,C,5804,0,5803,0,0,1,5803,1
6682,T,5991,1,0,0,0,5990,5990,1
6683,A,5987,5987,0,0,0,0,5987,0
6683,G,5802,1,0,5801,0,0,5801,1
6684,C,5798,0,5798,0,0,0,5798,0
6684,G,5987,0,0,5987,0,0,5987,0
6685,A,5785,5783,0,1,0,0,5783,2
6685,T,5960,0,0,0,0,5959,5959,1
6686,G,5960,0,0,5956,0,0,5956,4
6686,T,5784,0,4,0,0,5780,5780,4
6687,C,5784,0,5748,0,0,1,5748,36
6687,G,5956,0,0,5956,0,0,5956,0
6688,C,5783,0,5783,0,0,0,5783,0
6688,T,5920,0,0,0,0,5920,5920,0
6689,C,5780,0,5780,0,0,0,5780,0
6689,C,5920,0,5920,0,0,0,5920,0
6690,A,5905,5905,0,0,0,0,5905,0
6690,C,5779,0,5779,0,0,0,5779,0
6691,A,5770,5769,1,0,0,0,5769,1
6691,T,5905,0,0,0,0,5905,5905,0
6692,A,5904,5901,0,1,0,0,5901,3
6692,G,5770,1,0,5769,0,0,5769,1
6693,A,5904,5903,0,0,0,0,5903,1
6693,C,5767,0,5767,0,0,0,5767,0
6694,A,5763,5763,0,0,0,0,5763,0
6694,C,5902,0,5902,0,0,0,5902,0
6695,A,5856,5855,0,1,0,0,5855,1
6695,T,5753,0,0,0,0,5753,5753,0
6696,G,5745,0,0,5745,0,0,5745,0
6696,G,5856,1,0,5855,0,0,5855,1
6697,C,5856,0,5856,0,0,0,5856,0
6698,A,5850,5849,0,0,0,0,5849,1
6699,G,5850,0,0,5850,0,0,5850,0
6700,C,5838,0,5837,0,0,0,5837,1
6701,T,5837,0,0,0,0,5837,5837,0
6702,T,5836,0,1,0,0,5835,5835,1
6703,C,5828,1,5826,0,0,1,5826,2
6704,A,5826,5826,0,0,0,0,5826,0
6705,G,5826,0,0,5824,0,1,5824,2
6706,C,5825,0,5824,0,0,1,5824,1
6707,T,5824,1,1,0,0,5821,5821,3
6708,A,5810,5809,0,0,0,1,5809,1
6709,C,5807,0,5801,0,0,0,5801,6
6710,C,5804,1,5803,0,0,0,5803,1
6711,T,5804,0,0,0,0,5804,5804,0
6712,C,5802,0,5802,0,0,0,5802,0
6713,T,5799,0,0,0,0,5799,5799,0
6714,C,5799,1,5797,0,0,1,5797,2
6715,A,5795,5791,0,0,0,0,5791,4
6716,A,5795,5795,0,0,0,0,5795,0
6717,T,5795,0,0,0,0,5795,5795,0
6718,T,5789,0,0,0,0,5789,5789,0
6719,C,5788,0,5788,0,0,0,5788,0
6720,A,5782,5653,0,1,0,0,5653,129
6721,A,5780,5780,0,0,0,0,5780,0
6722,A,5782,5782,0,0,0,0,5782,0
6723,A,5779,5779,0,0,0,0,5779,0
6724,A,5777,5777,0,0,0,0,5777,0
6725,A,5769,5760,2,0,0,0,5760,9
6726,C,5762,1,5666,0,0,0,5666,96
6727,C,5768,0,5768,0,0,0,5768,0
6728,C,5767,1,5766,0,0,0,5766,1
6729,C,5766,0,5766,0,0,0,5766,0
6730,T,5765,1,0,0,0,5764,5764,1
6731,C,5765,0,5765,0,0,0,5765,0
6732,A,5765,5764,0,0,0,0,5764,1
6733,A,5765,5765,0,0,0,0,5765,0
6734,G,5765,0,0,5764,0,0,5764,1
6735,A,5760,5760,0,0,0,0,5760,0
6736,C,5760,0,5749,0,0,0,5749,11
6737,C,5748,0,5748,0,0,0,5748,0
6738,C,5725,1,5723,0,0,1,5723,2
6739,G,5724,0,0,5723,0,0,5723,1
6740,T,5725,0,0,0,0,5709,5709,16
6741,T,5725,0,0,0,0,5725,5725,0
6742,T,5725,0,0,0,0,5725,5725,0
6743,A,5723,5723,0,0,0,0,5723,0
6744,G,5723,0,0,5722,0,0,5722,1
6745,A,5713,5712,0,1,0,0,5712,1
6746,G,5711,0,0,5710,0,0,5710,1
6747,G,5703,1,0,5702,0,0,5702,1
6748,C,5672,0,5614,0,0,0,5614,58
6749,C,5671,0,5671,0,0,0,5671,0
6750,C,5671,0,5671,0,0,0,5671,0
6751,C,5671,0,5671,0,0,0,5671,0
6752,A,5671,5668,0,0,0,0,5668,3
6753,A,5671,5671,0,0,0,0,5671,0
6754,G,5671,0,0,5627,0,0,5627,44
6755,G,5666,0,0,5666,0,0,5666,0
6756,G,5660,1,0,5659,0,0,5659,1
6757,G,5633,0,0,5632,0,1,5632,1
6758,T,5606,0,0,0,0,5600,5600,6
6759,T,5598,0,1,0,0,5596,5596,2
6760,A,5595,5595,0,0,0,0,5595,0
6761,T,5596,0,0,0,0,5596,5596,0
6762,G,5596,0,0,5595,0,0,5595,1
6763,C,5594,0,5593,0,0,0,5593,1
6764,T,5540,0,0,0,0,5540,5540,0
6765,A,5540,5540,0,0,0,0,5540,0
6766,T,5535,0,0,0,0,5535,5535,0
6767,C,5535,0,5535,0,0,0,5535,0
6768,A,5534,5530,0,2,0,0,5530,4
6769,A,5531,5530,0,1,0,0,5530,1
6770,T,5528,0,0,0,0,5528,5528,0
6771,C,5509,0,5508,0,0,1,5508,1
6772,G,5477,0,0,5477,0,0,5477,0
6773,T,5476,0,0,0,0,5472,5472,4
6774,T,5467,0,0,0,0,5467,5467,0
6775,G,5467,0,0,5467,0,0,5467,0
6776,C,5466,1,5463,0,0,2,5463,3
6777,G,5466,0,0,5465,0,0,5465,1
6778,T,5465,0,1,0,0,5464,5464,1
6779,T,5463,0,0,0,0,5463,5463,0
6780,A,5463,5460,0,1,0,0,5460,3
6781,C,5461,0,5460,0,0,0,5460,1
6782,A,5462,5460,0,0,0,0,5460,2
6783,C,5461,0,5459,0,0,2,5459,2
6784,A,5428,5427,1,0,0,0,5427,1
6785,C,5428,0,5428,0,0,0,5428,0
6786,A,5419,5418,0,0,0,0,5418,1
6787,C,5419,1,5415,0,0,0,5415,4
6788,A,5418,5321,1,0,0,0,5321,97
6789,A,5416,5415,0,1,0,0,5415,1
6790,A,5417,5417,0,0,0,0,5417,0
6791,A,5417,5417,0,0,0,0,5417,0
6792,A,5417,5417,0,0,0,0,5417,0
6793,A,5416,5415,1,0,0,0,5415,1
6794,C,5415,3,5403,0,0,0,5403,12
6795,C,5412,0,5411,0,0,0,5411,1
6796,A,5394,5385,0,0,0,0,5385,9
6797,A,5395,5389,1,0,0,0,5389,6
6798,C,5390,0,5390,0,0,0,5390,0
6799,A,5395,5393,0,1,0,0,5393,2
6800,C,5395,0,5395,0,0,0,5395,0
6801,A,5382,5379,0,1,0,0,5379,3
6802,C,5382,0,5381,0,0,0,5381,1
6803,A,5379,5378,0,0,0,0,5378,1
6804,T,5379,0,0,0,0,5378,5378,1
6805,C,5379,0,5378,0,0,0,5378,1
6806,C,5372,0,5372,0,0,0,5372,0
6807,A,5365,5363,0,0,0,0,5363,2
6808,T,5365,0,0,0,0,5364,5364,1
6809,C,5360,0,5360,0,0,0,5360,0
6810,T,5359,0,0,0,0,5357,5357,2
6811,T,5355,0,0,0,0,5355,5355,0
6812,C,5355,0,5354,0,0,1,5354,1
6813,G,5344,0,0,5344,0,0,5344,0
6814,A,5343,5343,0,0,0,0,5343,0
6815,T,5343,0,0,0,0,5343,5343,0
6816,G,5340,1,0,5338,0,0,5338,2
6817,G,5337,1,0,5336,0,0,5336,1
6818,A,5329,5329,0,0,0,0,5329,0
6819,T,5329,0,0,0,0,5329,5329,0
6820,A,5320,5320,0,0,0,0,5320,0
6821,G,5320,0,0,5320,0,0,5320,0
6822,C,5318,0,5318,0,0,0,5318,0
6823,G,5314,0,0,5314,0,0,5314,0
6824,A,5311,5311,0,0,0,0,5311,0
